Player,Pos,Age,Tm,G,GS,MP,FG,FGA,FG%,3P,3PA,3P%,2P,2PA,2P%,eFG%,FT,FTA,FT%,ORB,DRB,TRB,AST,STL,BLK,TOV,PF,PTS,Salary
Precious Achiuwa,PF,21,MIA,61,4,737,124,228,0.543859649122807,0,1,0.0,124,227,0.546,0.543859649122807,56,110,0.509090909090909,73,135,208,29,20,28,43,91,304,2582160
Jaylen Adams,PG,24,MIL,7,0,18,1,8,0.125,0,2,0.0,1,6,0.16699999999999998,0.125,0,0,0.0,0,3,3,2,0,0,0,1,2,449115
Steven Adams,C,27,NOP,58,58,1605,189,308,0.6136363636363636,0,3,0.0,189,305,0.62,0.6136363636363636,60,135,0.4444444444444444,213,301,514,111,54,38,78,113,438,29592695
Bam Adebayo,C,23,MIA,64,64,2143,456,800,0.57,2,8,0.25,454,792,0.573,0.57125,283,354,0.7994350282485876,142,431,573,346,75,66,169,145,1197,5115492
LaMarcus Aldridge,C,35,BRK,52,46,1348,280,592,0.47297297297297297,62,160,0.3875,218,432,1.502,0.5253378378378378,82,94,0.8723404255319149,38,198,236,98,22,58,54,94,704,17628340
Ty-Shon Alexander,SG,22,PHO,15,0,47,3,12,0.25,2,9,0.2222222222222222,1,3,0.33299999999999996,0.3333333333333333,1,2,0.5,2,8,10,6,0,1,3,2,9,449115
Nickeil Alexander-Walker,SG,22,NOP,46,13,1007,192,458,0.4192139737991266,76,219,0.3470319634703196,116,239,0.485,0.5021834061135371,48,66,0.7272727272727273,13,131,144,102,47,22,69,88,508,3113160
Grayson Allen,SG,25,MEM,50,38,1259,173,414,0.4178743961352657,107,274,0.3905109489051095,66,140,0.47100000000000003,0.5471014492753623,79,91,0.8681318681318682,19,141,160,108,46,8,48,71,532,2545320
Jarrett Allen,C,22,CLE,126,90,3728,596,964,0.6182572614107884,12,38,0.3157894736842105,584,926,1.931,0.6244813278008299,408,580,0.7034482758620689,392,870,1262,212,64,180,200,192,1612,3909902
Al-Farouq Aminu,PF,30,CHI,46,28,868,76,198,0.3838383838383838,16,74,0.21621621621621623,60,124,1.234,0.42424242424242425,36,44,0.8181818181818182,44,176,220,62,38,18,56,58,204,9720900
Kyle Anderson,PF,27,MEM,69,69,1887,308,658,0.46808510638297873,94,261,0.36015325670498083,214,397,0.539,0.5395136778115501,144,184,0.782608695652174,52,344,396,250,84,57,86,120,854,9505100
Giannis Antetokounmpo,PF,26,MIL,61,61,2013,626,1100,0.5690909090909091,67,221,0.3031674208144796,559,879,0.636,0.5995454545454545,398,581,0.685025817555938,97,574,671,357,72,73,207,168,1717,27528088
Kostas Antetokounmpo,PF,23,LAL,15,0,56,3,10,0.3,0,0,0.0,3,10,0.3,0.3,6,13,0.46153846153846156,4,15,19,1,2,4,11,8,12,449115
Thanasis Antetokounmpo,SF,28,MIL,57,3,551,67,137,0.48905109489051096,7,29,0.2413793103448276,60,108,0.556,0.5145985401459854,25,49,0.5102040816326531,54,70,124,46,22,10,43,74,166,1701593
Carmelo Anthony,PF,36,POR,69,3,1690,327,777,0.42084942084942084,133,325,0.40923076923076923,194,452,0.429,0.5064350064350064,137,154,0.8896103896103896,32,182,214,104,46,38,61,144,924,2564753
Cole Anthony,PG,20,ORL,47,34,1273,219,552,0.3967391304347826,58,172,0.3372093023255814,161,380,0.424,0.4492753623188406,109,131,0.8320610687022901,38,183,221,192,30,18,106,98,605,3285120
OG Anunoby,SF,23,TOR,43,43,1433,249,519,0.4797687861271676,104,261,0.39846743295019155,145,258,0.562,0.5799614643545279,80,102,0.7843137254901961,54,183,237,94,66,32,75,114,682,3872215
Ryan Arcidiacono,PG,26,CHI,44,0,450,49,117,0.4188034188034188,25,67,0.373134328358209,24,50,0.48,0.5256410256410257,13,20,0.65,5,62,67,56,9,0,10,47,136,3000000
Trevor Ariza,SF,35,MIA,30,27,841,99,241,0.4107883817427386,50,143,0.34965034965034963,49,98,0.5,0.5145228215767634,34,44,0.7727272727272727,27,117,144,55,31,18,21,55,282,12800000
DJ Augustin,PG,33,HOU,114,24,2258,270,686,0.3935860058309038,166,434,0.3824884792626728,104,252,1.238,0.5145772594752187,170,188,0.9042553191489362,40,148,188,376,56,2,130,112,876,6666667
Deni Avdija,SF,20,WAS,54,32,1257,130,312,0.4166666666666667,53,168,0.31547619047619047,77,144,0.535,0.5016025641025641,29,45,0.6444444444444445,22,240,262,63,32,15,33,140,342,4469160
Deandre Ayton,C,22,PHO,69,69,2115,430,687,0.6259097525473072,4,20,0.2,426,667,0.639,0.62882096069869,133,173,0.7687861271676301,228,499,727,99,41,81,103,196,997,10018200
Udoka Azubuike,C,21,UTA,15,0,57,4,9,0.4444444444444444,0,0,0.0,4,9,0.444,0.4444444444444444,8,10,0.8,4,9,13,0,1,4,3,9,16,1977000
Dwayne Bacon,SG,25,ORL,72,50,1853,292,726,0.4022038567493113,59,207,0.28502415458937197,233,519,0.449,0.4428374655647383,145,176,0.8238636363636364,31,193,224,93,45,5,46,103,788,1678854
Marvin Bagley,PF,21,SAC,43,42,1112,247,490,0.5040816326530613,37,108,0.3425925925925926,210,382,0.55,0.5418367346938775,77,134,0.5746268656716418,106,212,318,43,21,21,59,100,608,8963640
LaMelo Ball,PG,19,CHO,51,31,1469,293,672,0.43601190476190477,92,261,0.3524904214559387,201,411,0.489,0.5044642857142857,125,165,0.7575757575757576,63,239,302,313,81,18,145,136,803,7839960
Lonzo Ball,PG,23,NOP,55,55,1747,290,700,0.4142857142857143,172,455,0.378021978021978,118,245,0.48200000000000004,0.5371428571428571,50,64,0.78125,33,230,263,316,82,31,123,103,802,11003782
Mo Bamba,C,22,ORL,46,5,725,142,301,0.4717607973421927,38,118,0.3220338983050847,104,183,0.568,0.5348837209302325,45,66,0.6818181818181818,76,189,265,35,14,58,36,87,367,5969040
Desmond Bane,SG,22,MEM,68,17,1519,234,499,0.46893787575150303,117,271,0.4317343173431734,117,228,0.513,0.5861723446893787,40,49,0.8163265306122449,31,179,210,118,41,16,59,125,625,1936440
Harrison Barnes,PF,28,SAC,58,58,2102,319,642,0.4968847352024922,100,256,0.390625,219,386,0.5670000000000001,0.5747663551401869,195,235,0.8297872340425532,64,321,385,201,43,11,93,75,933,22215909
RJ Barrett,SG,20,NYK,72,72,2511,467,1060,0.44056603773584907,124,309,0.40129449838187703,343,751,0.457,0.4990566037735849,206,276,0.7463768115942029,68,346,414,217,53,20,139,188,1264,8231760
Will Barton,SF,30,DEN,56,52,1736,259,608,0.42598684210526316,98,257,0.38132295719844356,161,351,0.45899999999999996,0.506578947368421,95,121,0.7851239669421488,39,187,226,181,50,23,96,95,711,13723214
Keita Bates-Diop,SF,25,SAS,30,0,245,30,67,0.44776119402985076,5,17,0.29411764705882354,25,50,0.5,0.48507462686567165,14,21,0.6666666666666666,9,40,49,12,11,5,7,11,79,449115
Nicolas Batum,SF,32,LAC,67,38,1835,191,412,0.46359223300970875,110,272,0.40441176470588236,81,140,0.579,0.5970873786407767,48,58,0.8275862068965517,50,266,316,148,69,37,53,102,540,11608231
Aron Baynes,C,34,TOR,53,31,980,134,304,0.4407894736842105,27,103,0.2621359223300971,107,201,0.532,0.48519736842105265,29,41,0.7073170731707317,87,186,273,47,17,23,46,119,324,7000000
Kent Bazemore,SF,31,GSW,67,18,1333,176,392,0.4489795918367347,75,184,0.4076086956521739,101,208,0.486,0.5446428571428571,54,78,0.6923076923076923,26,203,229,108,69,33,82,158,481,2320044
Darius Bazley,PF,20,OKC,55,55,1714,273,690,0.39565217391304347,83,286,0.2902097902097902,190,404,0.47,0.4557971014492754,125,178,0.702247191011236,51,345,396,99,29,25,122,60,754,2399160
Bradley Beal,SG,27,WAS,60,60,2147,670,1382,0.48480463096960924,130,373,0.3485254691689008,540,1009,0.535,0.5318379160636758,408,459,0.8888888888888888,72,211,283,265,69,22,187,140,1878,28751774
Malik Beasley,SG,24,MIN,37,36,1214,264,600,0.44,128,321,0.3987538940809969,136,279,0.48700000000000004,0.5466666666666666,68,80,0.85,28,134,162,88,30,7,60,62,724,13425895
Jordan Bell,C,26,GSW,12,2,164,14,44,0.3181818181818182,0,4,0.0,14,40,0.739,0.3181818181818182,2,4,0.5,14,34,48,14,6,10,8,14,30,822348
DeAndre Bembry,SF,26,TOR,51,12,972,117,228,0.5131578947368421,14,53,0.2641509433962264,103,175,0.589,0.543859649122807,45,66,0.6818181818181818,33,113,146,107,53,18,71,87,293,1737145
Davis Bertans,PF,28,WAS,57,7,1464,193,478,0.40376569037656906,169,428,0.39485981308411217,24,50,0.48,0.5805439330543933,100,115,0.8695652173913043,18,150,168,49,33,13,33,136,655,15000000
Patrick Beverley,PG,32,LAC,37,34,832,93,220,0.42272727272727273,56,141,0.3971631205673759,37,79,0.46799999999999997,0.55,36,45,0.8,29,90,119,76,29,28,34,108,278,13333333
Saddiq Bey,SF,21,DET,70,53,1909,279,691,0.4037626628075253,175,460,0.3804347826086957,104,231,0.45,0.5303907380607815,124,147,0.8435374149659864,43,275,318,95,52,14,60,110,857,2689920
Tyler Bey,SF,22,DAL,18,0,71,7,22,0.3181818181818182,1,4,0.25,6,18,0.33299999999999996,0.3409090909090909,3,5,0.6,8,11,19,3,0,1,3,6,18,449115
Khem Birch,C,28,TOR,134,44,3058,378,760,0.49736842105263157,26,104,0.25,352,656,1.63,0.5144736842105263,182,258,0.7054263565891473,348,426,774,178,96,100,88,226,964,3011499
Goga Bitadze,C,21,IND,45,3,561,83,194,0.42783505154639173,20,79,0.25316455696202533,63,115,0.5479999999999999,0.4793814432989691,45,61,0.7377049180327869,60,90,150,37,9,60,17,94,231,2957520
Bismack Biyombo,C,28,CHO,66,36,1349,142,242,0.5867768595041323,0,1,0.0,142,241,0.589,0.5867768595041323,47,105,0.44761904761904764,137,210,347,81,17,74,71,141,331,3500000
Nemanja Bjelica,PF,32,MIA,74,6,1190,178,392,0.45408163265306123,54,170,0.3176470588235294,124,222,1.65,0.5229591836734694,74,102,0.7254901960784313,58,196,254,138,30,10,66,136,484,7150000
Eric Bledsoe,SG,31,NOP,71,70,2111,307,730,0.42054794520547945,121,355,0.3408450704225352,186,375,0.496,0.5034246575342466,134,195,0.6871794871794872,29,215,244,268,55,24,114,112,869,16875000
Keljin Blevins,SF,25,POR,17,0,75,5,20,0.25,2,8,0.25,3,12,0.25,0.3,0,0,0.0,3,7,10,4,2,0,5,8,12,449115
Bogdan Bogdanovic,SG,28,ATL,44,27,1305,267,565,0.4725663716814159,146,333,0.43843843843843844,121,232,0.522,0.6017699115044248,40,44,0.9090909090909091,20,140,160,147,49,13,54,99,720,18000000
Bojan Bogdanovic,SF,31,UTA,72,72,2216,406,925,0.43891891891891893,180,461,0.39045553145336226,226,464,0.48700000000000004,0.5362162162162162,233,265,0.879245283018868,40,241,281,136,45,4,128,115,1225,17850000
Bol Bol,PF,21,DEN,32,2,160,25,58,0.43103448275862066,9,24,0.375,16,34,0.47100000000000003,0.5086206896551724,10,15,0.6666666666666666,0,24,24,7,3,10,13,14,69,2058240
Marques Bolden,C,22,CLE,6,0,29,1,3,0.3333333333333333,0,0,0.0,1,3,0.33299999999999996,0.3333333333333333,5,8,0.625,3,3,6,0,2,2,2,0,7,449115
Jordan Bone,PG,23,ORL,14,0,196,23,54,0.42592592592592593,10,32,0.3125,13,22,0.591,0.5185185185185185,0,0,0.0,4,20,24,18,2,0,3,11,56,135350
Isaac Bonga,SF,21,WAS,40,8,432,30,81,0.37037037037037035,13,47,0.2765957446808511,17,34,0.5,0.4506172839506173,5,8,0.625,18,48,66,23,11,9,22,63,78,1663861
Devin Booker,SG,24,PHO,67,67,2270,623,1287,0.4840714840714841,126,371,0.33962264150943394,497,916,0.5429999999999999,0.533022533022533,340,392,0.8673469387755102,34,247,281,289,53,16,207,181,1712,29467800
Chris Boucher,C,28,TOR,60,14,1453,288,560,0.5142857142857142,90,235,0.3829787234042553,198,325,0.609,0.5946428571428571,152,193,0.7875647668393783,117,287,404,63,35,111,46,166,818,6500000
Brian Bowen,SF,22,IND,6,0,15,1,4,0.25,0,1,0.0,1,3,0.33299999999999996,0.25,1,1,1.0,0,3,3,0,0,0,0,1,3,375321
Avery Bradley,SG,30,HOU,54,12,1204,128,342,0.3742690058479532,66,202,0.32673267326732675,62,140,1.3599999999999999,0.47076023391812866,24,30,0.8,16,98,114,92,42,6,56,110,346,5635000
Tony Bradley,C,23,OKC,84,16,1368,262,394,0.6649746192893401,0,6,0.0,262,388,2.031,0.6649746192893401,76,110,0.6909090909090909,170,308,478,74,30,60,66,122,600,3542060
Jarrell Brantley,PF,24,UTA,28,0,138,25,52,0.4807692307692308,12,28,0.42857142857142855,13,24,0.542,0.5961538461538461,2,2,1.0,9,18,27,15,7,2,8,17,64,510586
Ignas Brazdeikis,SF,22,ORL,26,0,498,70,166,0.42168674698795183,22,56,0.39285714285714285,48,110,0.898,0.4879518072289157,20,28,0.7142857142857143,22,68,90,34,8,6,24,44,182,1686315
Mikal Bridges,SF,24,PHO,72,72,2348,363,669,0.5426008968609866,134,315,0.4253968253968254,229,354,0.647,0.6427503736920778,110,131,0.8396946564885496,76,233,309,152,76,63,57,116,970,4359000
Miles Bridges,PF,22,CHO,66,19,1932,313,622,0.5032154340836013,116,290,0.4,197,332,0.593,0.5964630225080386,98,113,0.8672566371681416,81,316,397,147,44,52,106,143,840,3934320
Amida Brimah,C,26,IND,5,0,29,5,8,0.625,0,0,0.0,5,8,0.625,0.625,3,3,1.0,2,6,8,1,0,5,4,4,13,123056
Oshae Brissett,SF,22,IND,21,16,519,73,151,0.48344370860927155,33,78,0.4230769230769231,40,73,0.5479999999999999,0.5927152317880795,50,65,0.7692307692307693,29,86,115,18,19,20,10,32,229,1255493
Malcolm Brogdon,PG,28,IND,56,56,1930,444,980,0.4530612244897959,145,374,0.3877005347593583,299,606,0.493,0.5270408163265307,153,177,0.864406779661017,58,236,294,329,49,15,115,110,1186,20700000
Armoni Brooks,SG,22,HOU,20,5,520,78,192,0.40625,60,157,0.3821656050955414,18,35,0.514,0.5625,7,12,0.5833333333333334,10,58,68,30,12,5,22,34,223,135362
Dillon Brooks,SF,25,MEM,67,67,1997,432,1031,0.4190106692531523,128,372,0.34408602150537637,304,659,0.461,0.481086323957323,159,195,0.8153846153846154,53,143,196,157,78,26,119,237,1151,11400000
Bruce Brown,PG,24,BRK,65,37,1451,235,423,0.5555555555555556,17,59,0.288135593220339,218,364,0.599,0.5756501182033097,86,117,0.7350427350427351,111,238,349,104,58,28,54,145,573,1663861
Charlie Brown,SG,23,OKC,9,1,152,13,43,0.3023255813953488,5,21,0.23809523809523808,8,22,0.364,0.36046511627906974,9,10,0.9,3,14,17,9,4,2,6,19,40,217844
Jaylen Brown,SG,24,BOS,58,58,1999,538,1111,0.48424842484248426,163,411,0.39659367396593675,375,700,0.536,0.5576057605760576,191,250,0.764,71,276,347,195,72,32,158,168,1430,25035118
Moses Brown,C,21,OKC,43,32,920,146,268,0.5447761194029851,0,0,0.0,146,268,0.545,0.5447761194029851,78,126,0.6190476190476191,154,229,383,10,31,47,43,93,370,1250000
Sterling Brown,SG,25,HOU,51,14,1229,150,335,0.44776119402985076,91,215,0.4232558139534884,59,120,0.49200000000000005,0.5835820895522388,25,31,0.8064516129032258,38,186,224,72,38,12,41,97,416,1678854
Troy Brown,SF,21,CHI,68,0,1048,124,288,0.4305555555555556,44,140,0.3142857142857143,80,148,1.6600000000000001,0.5069444444444444,30,42,0.7142857142857143,40,170,210,58,20,12,42,98,322,3372840
Jalen Brunson,PG,24,DAL,68,12,1697,328,627,0.5231259968102073,81,200,0.405,247,427,0.578,0.5877192982456141,120,151,0.7947019867549668,27,204,231,239,35,1,80,109,857,1663861
Elijah Bryant,SG,25,MIL,1,0,32,6,13,0.46153846153846156,1,5,0.2,5,8,0.625,0.5,3,3,1.0,2,4,6,3,0,1,4,4,16,24611
Thomas Bryant,C,23,WAS,10,10,271,59,91,0.6483516483516484,9,21,0.42857142857142855,50,70,0.7140000000000001,0.6978021978021978,16,24,0.6666666666666666,18,43,61,15,4,8,11,31,143,8333333
Reggie Bullock,SF,29,NYK,65,64,1949,248,561,0.44206773618538325,163,398,0.40954773869346733,85,163,0.521,0.5873440285204992,50,55,0.9090909090909091,16,207,223,99,52,11,45,146,709,4200000
Trey Burke,PG,28,DAL,62,1,911,151,353,0.42776203966005666,58,164,0.35365853658536583,93,189,0.49200000000000005,0.509915014164306,51,57,0.8947368421052632,10,44,54,81,36,7,33,64,411,3000000
Alec Burks,SG,29,NYK,49,5,1255,210,500,0.42,102,246,0.4146341463414634,108,254,0.425,0.522,101,118,0.8559322033898306,21,206,227,107,31,14,49,102,623,6000000
Jimmy Butler,SF,31,MIA,52,52,1745,366,736,0.49728260869565216,25,102,0.24509803921568626,341,634,0.5379999999999999,0.514266304347826,359,416,0.8629807692307693,94,265,359,369,108,18,109,71,1116,34379100
Bruno Caboclo,PF,25,HOU,6,0,36,8,17,0.47058823529411764,0,5,0.0,8,12,0.667,0.47058823529411764,1,2,0.5,3,11,14,1,0,2,4,6,17,2028594
Devontae Cacok,PF,24,LAL,20,1,98,17,29,0.5862068965517241,0,0,0.0,17,29,0.586,0.5862068965517241,5,11,0.45454545454545453,12,20,32,1,5,4,5,8,39,449115
Kentavious Caldwell-Pope,SG,27,LAL,67,67,1902,218,506,0.4308300395256917,120,293,0.40955631399317405,98,213,0.46,0.549407114624506,97,112,0.8660714285714286,27,152,179,127,62,26,66,114,653,12073020
Facundo Campazzo,PG,29,DEN,65,19,1425,120,315,0.38095238095238093,76,216,0.35185185185185186,44,99,0.444,0.5015873015873016,80,91,0.8791208791208791,22,112,134,232,79,14,73,132,396,3200000
Vlatko Cancar,PF,23,DEN,41,1,281,33,72,0.4583333333333333,9,33,0.2727272727272727,24,39,0.615,0.5208333333333334,10,13,0.7692307692307693,11,39,50,14,11,2,14,18,85,1517981
Devin Cannady,PG,24,ORL,8,0,74,11,28,0.39285714285714285,6,16,0.375,5,12,0.41700000000000004,0.5,6,7,0.8571428571428571,0,5,5,1,5,1,2,9,34,95369
Clint Capela,C,26,ATL,63,63,1898,413,695,0.5942446043165468,0,0,0.0,413,695,0.594,0.5942446043165468,130,227,0.5726872246696035,297,606,903,49,44,129,73,145,956,18000000
Vernon Carey,C,19,CHO,19,4,115,18,36,0.5,1,7,0.14285714285714285,17,29,0.586,0.5138888888888888,9,11,0.8181818181818182,6,21,27,2,1,5,5,13,46,1350000
Jevon Carter,PG,25,PHO,60,1,717,94,223,0.42152466367713004,56,151,0.3708609271523179,38,72,0.528,0.547085201793722,4,7,0.5714285714285714,16,76,92,71,29,9,16,56,248,3925000
Wendell Carter,C,21,ORL,108,88,2750,460,914,0.5032822757111597,30,102,0.29411764705882354,430,812,1.59,0.5196936542669585,262,358,0.7318435754189944,264,622,886,208,70,84,156,292,1212,5448840
Michael Carter-Williams,SG,29,ORL,31,25,800,105,270,0.3888888888888889,15,61,0.2459016393442623,90,209,0.431,0.4166666666666667,49,80,0.6125,39,100,139,129,25,17,69,81,274,3300000
Alex Caruso,PG,26,LAL,58,6,1216,133,305,0.4360655737704918,55,137,0.40145985401459855,78,168,0.46399999999999997,0.5262295081967213,49,76,0.6447368421052632,31,139,170,160,64,15,76,108,370,2750000
Willie Cauley-Stein,C,27,DAL,53,16,906,115,182,0.6318681318681318,1,11,0.09090909090909091,114,171,0.667,0.6346153846153846,49,78,0.6282051282051282,66,170,236,35,21,43,29,129,280,4100000
Chris Chiozza,PG,25,BRK,22,1,232,31,88,0.3522727272727273,13,42,0.30952380952380953,18,46,0.391,0.42613636363636365,13,17,0.7647058823529411,3,21,24,65,7,6,16,19,88,449115
Marquese Chriss,PF,23,GSW,2,0,27,5,14,0.35714285714285715,1,5,0.2,4,9,0.444,0.39285714285714285,2,4,0.5,3,10,13,2,0,2,2,3,13,1824003
Gary Clark,PF,26,PHI,78,22,1308,80,264,0.30303030303030304,62,216,0.28703703703703703,18,48,0.766,0.42045454545454547,16,20,0.8,66,164,230,62,26,14,34,70,238,2018458
Brandon Clarke,PF,24,MEM,59,16,1415,256,495,0.5171717171717172,20,77,0.2597402597402597,236,418,0.565,0.5373737373737374,78,113,0.6902654867256637,97,231,328,95,60,51,33,84,610,2602920
Jordan Clarkson,SG,28,UTA,68,1,1818,457,1075,0.42511627906976746,208,599,0.34724540901502504,249,476,0.523,0.521860465116279,129,144,0.8958333333333334,47,227,274,168,61,10,115,110,1251,11500000
Nicolas Claxton,C,21,BRK,32,1,594,90,145,0.6206896551724138,1,5,0.2,89,140,0.636,0.6241379310344828,31,64,0.484375,43,123,166,28,23,40,18,68,212,1517981
Amir Coffey,SG,23,LAC,44,1,394,45,103,0.4368932038834951,23,56,0.4107142857142857,22,47,0.46799999999999997,0.5485436893203883,27,38,0.7105263157894737,10,34,44,22,10,0,15,30,140,578842
John Collins,PF,23,ATL,63,63,1848,429,771,0.556420233463035,83,208,0.39903846153846156,346,563,0.615,0.6102464332036317,170,204,0.8333333333333334,118,349,467,78,34,63,84,193,1111,4137302
Mike Conley,PG,33,UTA,51,51,1498,284,640,0.44375,138,335,0.41194029850746267,146,305,0.479,0.5515625,121,142,0.852112676056338,36,141,177,305,70,9,99,98,827,34502132
Pat Connaughton,SG,28,MIL,69,4,1575,168,387,0.43410852713178294,101,272,0.3713235294117647,67,115,0.583,0.5645994832041343,31,40,0.775,63,269,332,81,49,23,33,99,468,4938273
Quinn Cook,PG,27,CLE,46,0,314,58,136,0.4264705882352941,22,52,0.4230769230769231,36,84,1.3459999999999999,0.5073529411764706,14,16,0.875,4,30,34,36,8,2,14,20,152,1981649
Tyler Cook,SF,23,DET,64,2,876,138,206,0.6699029126213593,2,4,0.5,136,202,1.69,0.6747572815533981,34,70,0.4857142857142857,56,134,190,34,16,4,42,70,312,693141
DeMarcus Cousins,C,30,LAC,82,22,1426,260,610,0.4262295081967213,94,270,0.34814814814814815,166,340,1.48,0.5032786885245901,118,162,0.7283950617283951,106,420,526,152,68,48,128,214,732,3051832
Robert Covington,PF,30,POR,70,70,2243,204,509,0.40078585461689586,135,356,0.3792134831460674,69,153,0.451,0.5333988212180747,50,62,0.8064516129032258,61,405,466,117,101,84,64,195,593,12138345
Torrey Craig,SF,30,PHO,100,16,1606,218,454,0.4801762114537445,78,212,0.36792452830188677,140,242,1.615,0.566079295154185,34,44,0.7727272727272727,114,280,394,98,56,52,50,166,548,1678854
Jae Crowder,PF,30,PHO,60,42,1648,199,492,0.40447154471544716,148,380,0.3894736842105263,51,112,0.455,0.5548780487804879,57,75,0.76,32,250,282,127,48,27,55,125,603,9258000
Jarrett Culver,SG,21,MIN,34,7,499,69,168,0.4107142857142857,13,53,0.24528301886792453,56,115,0.48700000000000004,0.4494047619047619,29,48,0.6041666666666666,34,70,104,24,17,9,28,58,180,6104280
Seth Curry,SG,30,PHI,57,57,1638,258,552,0.4673913043478261,126,280,0.45,132,272,0.485,0.5815217391304348,69,77,0.8961038961038961,10,126,136,155,44,8,65,96,711,7834449
Stephen Curry,PG,32,GSW,63,63,2152,658,1365,0.48205128205128206,337,801,0.4207240948813982,321,564,0.569,0.6054945054945055,362,395,0.9164556962025316,29,316,345,363,77,8,213,119,2015,43006362
Nate Darling,SG,22,CHO,7,0,26,2,7,0.2857142857142857,2,7,0.2857142857142857,0,0,0.0,0.42857142857142855,3,3,1.0,1,0,1,1,0,1,1,1,9,449115
Anthony Davis,PF,27,LAL,36,36,1162,301,613,0.4910277324632953,26,100,0.26,275,513,0.536,0.5122349102773246,158,214,0.7383177570093458,62,224,286,110,45,59,74,60,786,32742000
Ed Davis,C,31,MIN,23,7,299,19,44,0.4318181818181818,0,0,0.0,19,44,0.43200000000000005,0.4318181818181818,10,12,0.8333333333333334,46,69,115,21,13,13,7,56,48,5005350
Terence Davis,SG,23,SAC,122,8,2148,390,912,0.4276315789473684,196,534,0.36704119850187267,194,378,1.537,0.5350877192982456,90,110,0.8181818181818182,40,268,308,166,88,28,126,194,1066,1517981
Gabriel Deck,PF,25,OKC,10,0,212,32,67,0.47761194029850745,2,15,0.13333333333333333,30,52,0.5770000000000001,0.4925373134328358,18,22,0.8181818181818182,16,24,40,24,8,0,6,9,84,3870370
Dewayne Dedmon,C,31,MIA,16,0,210,46,65,0.7076923076923077,1,5,0.2,45,60,0.75,0.7153846153846154,20,27,0.7407407407407407,28,58,86,12,9,6,13,36,113,3447478
Matthew Dellavedova,PG,30,CLE,13,1,224,14,56,0.25,4,25,0.16,10,31,0.32299999999999995,0.2857142857142857,4,4,1.0,6,18,24,58,4,1,6,21,36,2174318
DeMar DeRozan,PF,31,SAS,61,61,2056,455,920,0.4945652173913043,19,74,0.25675675675675674,436,846,0.515,0.5048913043478261,387,440,0.8795454545454545,40,219,259,422,56,15,119,128,1316,27739975
Mamadi Diakite,PF,24,MIL,14,1,141,16,40,0.4,1,8,0.125,15,32,0.469,0.4125,11,14,0.7857142857142857,8,26,34,8,7,6,3,16,44,529341
Hamidou Diallo,SF,22,DET,104,18,2452,448,940,0.4765957446808511,56,164,0.34146341463414637,392,776,1.509,0.5063829787234042,256,400,0.64,118,426,544,202,82,48,152,268,1208,1663861
Gorgui Dieng,C,31,SAS,76,2,1104,170,326,0.5214723926380368,60,140,0.42857142857142855,110,186,1.808,0.6134969325153374,116,134,0.8656716417910447,80,200,280,96,52,32,64,112,516,17587688
Spencer Dinwiddie,SG,27,BRK,3,3,64,6,16,0.375,2,7,0.2857142857142857,4,9,0.444,0.4375,6,6,1.0,0,13,13,9,2,1,5,4,20,11454048
Donte DiVincenzo,SG,24,MIL,66,66,1814,253,603,0.41956882255389716,131,346,0.3786127167630058,122,257,0.475,0.5281923714759535,51,71,0.7183098591549296,81,299,380,203,72,15,91,112,688,3044160
Luka Doncic,PG,21,DAL,66,66,2262,647,1351,0.4789045151739452,192,548,0.35036496350364965,455,803,0.5670000000000001,0.5499629903774982,344,471,0.7303609341825902,54,473,527,567,64,36,281,152,1830,8049360
Luguentz Dort,SG,21,OKC,52,52,1543,247,639,0.3865414710485133,113,329,0.3434650455927052,134,310,0.43200000000000005,0.4749608763693271,122,164,0.7439024390243902,38,151,189,88,45,19,79,134,729,1517981
Damyean Dotson,SG,26,CLE,46,7,907,119,293,0.4061433447098976,46,159,0.2893081761006289,73,134,0.545,0.48464163822525597,24,36,0.6666666666666666,5,88,93,91,16,4,42,42,308,2000000
Devon Dotson,PG,21,CHI,11,0,50,11,21,0.5238095238095238,1,7,0.14285714285714285,10,14,0.7140000000000001,0.5476190476190477,0,0,0.0,2,3,5,7,4,0,0,3,23,449115
Sekou Doumbouya,PF,20,DET,56,11,869,107,282,0.37943262411347517,26,115,0.22608695652173913,81,167,0.485,0.425531914893617,45,64,0.703125,39,104,143,47,24,9,44,94,285,3449400
PJ Dozier,SG,24,DEN,50,6,1088,148,355,0.4169014084507042,47,149,0.31543624161073824,101,206,0.49,0.4830985915492958,42,66,0.6363636363636364,35,147,182,92,31,22,46,86,385,1762796
Goran Dragic,PG,34,MIA,50,11,1337,240,555,0.43243243243243246,91,244,0.3729508196721312,149,311,0.479,0.5144144144144144,101,122,0.8278688524590164,25,144,169,219,33,8,118,113,672,18000000
Andre Drummond,C,27,LAL,92,92,2484,564,1144,0.493006993006993,0,16,0.0,564,1128,1.5150000000000001,0.493006993006993,246,410,0.6,332,770,1102,188,126,98,248,298,1374,28751774
Jared Dudley,PF,35,LAL,12,0,81,2,9,0.2222222222222222,2,6,0.3333333333333333,0,3,0.0,0.3333333333333333,0,0,0.0,4,17,21,5,1,1,2,7,6,2564753
Kris Dunn,PG,26,ATL,4,0,45,1,12,0.08333333333333333,0,2,0.0,1,10,0.1,0.08333333333333333,3,4,0.75,0,6,6,2,2,2,3,10,5,4767000
Kevin Durant,PF,32,BRK,35,32,1157,324,603,0.5373134328358209,85,189,0.4497354497354497,239,414,0.5770000000000001,0.6077943615257048,210,238,0.8823529411764706,13,234,247,195,25,45,120,70,943,39058950
Anthony Edwards,SG,19,MIN,72,55,2314,505,1211,0.41701073492981006,171,520,0.32884615384615384,334,691,0.483,0.4876135425268373,211,272,0.7757352941176471,59,277,336,211,82,36,160,129,1392,9757440
Carsen Edwards,SG,22,BOS,31,1,276,47,111,0.42342342342342343,18,63,0.2857142857142857,29,48,0.604,0.5045045045045045,11,13,0.8461538461538461,3,23,26,14,7,1,7,25,123,1517981
CJ Elleby,SF,20,POR,30,0,192,25,66,0.3787878787878788,7,34,0.20588235294117646,18,32,0.563,0.4318181818181818,11,15,0.7333333333333333,11,21,32,10,6,3,5,27,68,898310
Henry Ellenson,PF,24,TOR,2,0,38,5,14,0.35714285714285715,2,9,0.2222222222222222,3,5,0.6,0.42857142857142855,3,4,0.75,3,9,12,5,0,0,0,7,15,168983
Wayne Ellington,SG,33,DET,46,31,1012,149,338,0.4408284023668639,116,275,0.4218181818181818,33,63,0.524,0.6124260355029586,28,35,0.8,12,73,85,67,18,9,33,59,442,3564753
Joel Embiid,C,26,PHI,51,51,1585,461,899,0.5127919911012235,58,154,0.37662337662337664,403,745,0.541,0.5450500556173526,471,548,0.8594890510948905,113,426,539,145,50,69,159,123,1451,29542010
James Ennis,SF,30,ORL,41,37,986,115,243,0.4732510288065844,45,104,0.4326923076923077,70,139,0.504,0.565843621399177,70,87,0.8045977011494253,43,123,166,62,32,7,36,84,345,3300000
Drew Eubanks,C,23,SAS,54,3,755,116,205,0.5658536585365853,2,2,1.0,114,203,0.562,0.5707317073170731,77,106,0.7264150943396226,74,167,241,42,18,49,45,88,311,1620564
Dante Exum,SG,25,CLE,6,3,116,10,26,0.38461538461538464,2,11,0.18181818181818182,8,15,0.5329999999999999,0.4230769230769231,1,2,0.5,2,15,17,13,4,2,7,9,23,9600000
Tacko Fall,C,25,BOS,19,0,136,21,29,0.7241379310344828,0,0,0.0,21,29,0.7240000000000001,0.7241379310344828,5,15,0.3333333333333333,16,36,52,3,1,20,6,22,47,653924
Derrick Favors,C,29,UTA,68,0,1039,155,243,0.6378600823045267,0,2,0.0,155,241,0.643,0.6378600823045267,59,80,0.7375,138,238,376,44,32,68,36,143,369,9258000
Cristiano Felicio,C,28,CHI,18,0,84,7,13,0.5384615384615384,0,2,0.0,7,11,0.636,0.5384615384615384,9,16,0.5625,10,16,26,9,4,0,4,10,23,7529020
Terrance Ferguson,SG,22,PHI,13,0,49,1,7,0.14285714285714285,0,5,0.0,1,2,0.5,0.14285714285714285,0,0,0.0,0,1,1,2,1,0,4,7,2,3944013
Bruno Fernando,C,22,ATL,33,0,226,18,44,0.4090909090909091,0,2,0.0,18,42,0.429,0.4090909090909091,15,22,0.6818181818181818,16,62,78,10,4,3,21,23,51,1517981
Yogi Ferrell,PG,27,LAC,20,0,272,40,114,0.3508771929824561,18,56,0.32142857142857145,22,58,1.149,0.4298245614035088,14,18,0.7777777777777778,10,28,38,44,14,6,6,22,112,563131
Dorian Finney-Smith,PF,27,DAL,60,60,1921,220,466,0.4721030042918455,119,302,0.39403973509933776,101,164,0.616,0.5997854077253219,31,41,0.7560975609756098,98,228,326,102,52,25,48,138,590,4000000
Malik Fitts,PF,23,LAC,3,0,11,1,3,0.3333333333333333,1,2,0.5,0,1,0.0,0.5,0,0,0.0,0,3,3,0,0,0,0,3,3,61528
Malachi Flynn,PG,22,TOR,47,14,928,127,340,0.3735294117647059,54,168,0.32142857142857145,73,172,0.424,0.45294117647058824,45,56,0.8035714285714286,10,106,116,137,38,7,43,68,353,1950600
Bryn Forbes,SG,27,MIL,70,10,1354,250,529,0.4725897920604915,154,341,0.45161290322580644,96,188,0.511,0.6181474480151229,47,61,0.7704918032786885,11,101,112,45,24,1,44,77,701,2337145
Trent Forrest,PG,22,UTA,30,0,302,32,71,0.4507042253521127,5,26,0.19230769230769232,27,45,0.6,0.4859154929577465,19,19,1.0,11,33,44,45,9,4,21,22,88,470690
Evan Fournier,SG,28,BOS,84,72,2518,494,1082,0.4565619223659889,234,566,0.4134275618374558,260,516,1.469,0.5646950092421442,216,274,0.7883211678832117,20,236,256,288,94,38,146,192,1438,17150000
De'Aaron Fox,PG,23,SAC,58,58,2036,529,1110,0.4765765765765766,103,320,0.321875,426,790,0.539,0.522972972972973,300,417,0.7194244604316546,33,170,203,417,87,27,174,170,1461,8099627
Robert Franks,PF,24,ORL,7,0,101,13,28,0.4642857142857143,5,15,0.3333333333333333,8,13,0.615,0.5535714285714286,12,13,0.9230769230769231,6,8,14,5,3,3,2,8,43,198040
Tim Frazier,PG,30,MEM,5,0,62,3,20,0.15,0,8,0.0,3,12,0.25,0.15,2,6,0.3333333333333333,0,8,8,16,2,1,4,7,8,597463
Markelle Fultz,PG,22,ORL,8,8,215,41,104,0.3942307692307692,4,16,0.25,37,88,0.42,0.41346153846153844,17,19,0.8947368421052632,5,20,25,43,8,2,18,18,103,12288697
Wenyen Gabriel,PF,23,NOP,21,0,241,24,60,0.4,13,32,0.40625,11,28,0.39299999999999996,0.5083333333333333,11,17,0.6470588235294118,20,34,54,11,9,8,15,32,72,1620564
Daniel Gafford,C,22,WAS,108,22,1582,308,450,0.6844444444444444,0,0,0.0,308,450,2.055,0.6844444444444444,144,216,0.6666666666666666,188,274,462,58,52,150,82,196,760,1517981
Danilo Gallinari,PF,32,ATL,51,4,1222,206,475,0.4336842105263158,103,254,0.40551181102362205,103,221,0.466,0.5421052631578948,161,174,0.9252873563218391,17,194,211,76,30,10,43,105,676,19500000
Langston Galloway,SG,29,PHO,40,0,438,66,147,0.4489795918367347,36,85,0.4235294117647059,30,62,0.484,0.5714285714285714,22,23,0.9565217391304348,7,35,42,26,8,0,13,25,190,2028594
Darius Garland,PG,21,CLE,54,50,1790,362,802,0.4513715710723192,105,266,0.39473684210526316,257,536,0.479,0.5168329177057357,112,132,0.8484848484848485,23,106,129,329,66,6,164,110,941,6720720
Marc Gasol,C,36,LAL,52,42,993,88,194,0.4536082474226804,50,122,0.4098360655737705,38,72,0.528,0.5824742268041238,36,50,0.72,38,177,215,109,26,58,53,115,262,2564753
Rudy Gay,PF,34,SAS,63,1,1358,264,628,0.42038216560509556,106,278,0.381294964028777,158,350,0.451,0.5047770700636943,82,102,0.803921568627451,42,261,303,88,45,40,65,115,716,14500000
Paul George,SF,30,LAC,54,54,1821,445,953,0.4669464847848898,171,416,0.4110576923076923,274,537,0.51,0.5566631689401889,198,228,0.868421052631579,45,314,359,280,62,24,179,132,1259,35450412
Taj Gibson,PF,35,NYK,45,3,936,99,158,0.6265822784810127,3,15,0.2,96,143,0.6709999999999999,0.6360759493670886,40,55,0.7272727272727273,99,151,250,36,31,49,22,99,241,3283684
Harry Giles,C,22,POR,38,0,348,42,97,0.4329896907216495,8,23,0.34782608695652173,34,74,0.45899999999999996,0.4742268041237113,16,27,0.5925925925925926,31,102,133,29,8,13,20,54,108,1620564
Shai Gilgeous-Alexander,SG,22,OKC,35,35,1180,287,565,0.5079646017699115,71,170,0.4176470588235294,216,395,0.547,0.5707964601769911,185,229,0.8078602620087336,19,147,166,207,27,23,106,70,830,4141320
Anthony Gill,PF,28,WAS,26,4,218,30,60,0.5,7,24,0.2916666666666667,23,36,0.639,0.5583333333333333,13,16,0.8125,16,35,51,11,10,4,8,27,80,898310
Freddie Gillespie,PF,23,TOR,20,2,392,44,84,0.5238095238095238,0,0,0.0,44,84,0.524,0.5238095238095238,23,33,0.696969696969697,42,55,97,9,13,20,12,43,111,363015
Rudy Gobert,C,28,UTA,71,71,2187,391,579,0.6753022452504318,0,4,0.0,391,575,0.68,0.6753022452504318,233,374,0.6229946524064172,240,720,960,89,40,190,118,163,1015,26775281
Brandon Goodwin,PG,25,ATL,47,5,620,84,223,0.37668161434977576,32,103,0.3106796116504854,52,120,0.433,0.4484304932735426,28,43,0.6511627906976745,8,61,69,95,17,0,36,41,228,1701593
Aaron Gordon,PF,25,DEN,100,100,2768,462,998,0.46292585170340683,118,352,0.3352272727272727,344,646,1.6139999999999999,0.5220440881763527,194,298,0.6510067114093959,154,414,568,322,66,68,194,178,1236,18136364
Eric Gordon,SG,32,HOU,27,13,789,159,367,0.4332425068119891,69,210,0.32857142857142857,90,157,0.573,0.5272479564032697,94,114,0.8245614035087719,8,50,58,71,14,13,51,44,481,16869267
Devonte Graham,PG,25,CHO,55,44,1659,252,669,0.37668161434977576,179,477,0.3752620545073375,73,192,0.38,0.5104633781763827,133,158,0.8417721518987342,22,126,148,295,48,6,84,77,816,1663861
Jerami Grant,SF,26,DET,54,54,1829,400,932,0.4291845493562232,115,329,0.3495440729483283,285,603,0.473,0.49087982832618027,290,343,0.8454810495626822,35,215,250,152,35,58,109,125,1205,19050000
Danny Green,SF,33,PHI,69,69,1934,224,544,0.4117647058823529,175,432,0.4050925925925926,49,112,0.43799999999999994,0.5726102941176471,31,40,0.775,55,205,260,118,92,56,67,125,654,15365853
Draymond Green,PF,30,GSW,63,63,1982,170,380,0.4473684210526316,34,126,0.2698412698412698,136,254,0.535,0.4921052631578947,70,88,0.7954545454545454,55,394,449,558,105,52,188,194,444,22246956
JaMychal Green,PF,30,DEN,58,5,1120,173,374,0.4625668449197861,79,198,0.398989898989899,94,176,0.534,0.5681818181818182,46,57,0.8070175438596491,85,192,277,53,26,22,53,144,471,7199760
Javonte Green,PG,27,CHI,82,4,946,106,204,0.5196078431372549,20,60,0.3333333333333333,86,144,1.728,0.5686274509803921,60,80,0.75,52,90,142,34,56,12,38,90,292,1517981
Jeff Green,C,34,BRK,68,38,1835,261,530,0.49245283018867925,103,250,0.412,158,280,0.564,0.589622641509434,125,161,0.7763975155279503,34,229,263,108,36,27,54,122,750,2564753
Josh Green,SG,20,DAL,39,5,445,42,93,0.45161290322580644,4,25,0.16,38,68,0.5589999999999999,0.4731182795698925,13,23,0.5652173913043478,28,50,78,28,16,3,17,35,101,2816760
Blake Griffin,PF,31,BRK,92,60,2372,348,822,0.4233576642335766,140,410,0.34146341463414637,208,412,1.508,0.5085158150851582,174,234,0.7435897435897436,70,380,450,280,64,30,124,222,1010,33900241
Kyle Guy,PG,23,SAC,31,0,235,29,88,0.32954545454545453,13,46,0.2826086956521739,16,42,0.381,0.4034090909090909,16,20,0.8,5,30,35,32,6,0,11,20,87,537888
Rui Hachimura,PF,22,WAS,57,57,1797,310,648,0.4783950617283951,45,137,0.3284671532846715,265,511,0.519,0.5131172839506173,124,161,0.7701863354037267,49,263,312,82,44,7,68,120,789,4692840
Ashton Hagans,PG,21,MIN,2,0,4,0,0,0.0,0,0,0.0,0,0,0.0,0.0,0,0,0.0,0,0,0,0,0,0,1,0,0,166111
Tyrese Haliburton,PG,20,SAC,58,20,1746,292,619,0.4717285945072698,121,296,0.40878378378378377,171,323,0.529,0.5694668820678513,48,56,0.8571428571428571,39,134,173,309,77,28,92,83,753,3831840
Donta Hall,PF,23,ORL,13,0,179,25,35,0.7142857142857143,0,0,0.0,25,35,0.7140000000000001,0.7142857142857143,23,34,0.6764705882352942,24,38,62,11,5,10,8,18,73,376276
Josh Hall,SF,20,OKC,21,1,336,30,99,0.30303030303030304,4,37,0.10810810810810811,26,62,0.419,0.32323232323232326,22,44,0.5,6,53,59,28,4,1,25,37,86,449115
RJ Hampton,SG,19,ORL,102,2,1776,272,626,0.43450479233226835,54,174,0.3103448275862069,218,452,1.4420000000000002,0.4776357827476038,110,164,0.6707317073170732,58,300,358,174,42,20,106,122,708,2193480
Tim Hardaway,SG,28,DAL,70,31,1985,407,911,0.446761800219539,207,529,0.391304347826087,200,382,0.524,0.5603732162458837,142,174,0.8160919540229885,20,209,229,126,31,11,64,111,1163,18975000
James Harden,PG,31,BRK,88,86,3218,684,1468,0.4659400544959128,242,668,0.36227544910179643,442,800,1.661,0.5483651226158038,556,646,0.8606811145510835,70,626,696,950,106,66,354,198,2166,41254920
Maurice Harkless,PF,27,SAC,74,46,1544,138,330,0.41818181818181815,46,168,0.27380952380952384,92,162,1.15,0.48787878787878786,66,86,0.7674418604651163,26,152,178,88,60,40,44,172,388,3623000
Jared Harper,PG,23,NYK,8,0,16,0,4,0.0,0,1,0.0,0,3,0.0,0.0,3,4,0.75,0,2,2,1,0,0,3,1,3,520487
Montrezl Harrell,C,27,LAL,69,1,1580,375,603,0.6218905472636815,0,10,0.0,375,593,0.632,0.6218905472636815,181,256,0.70703125,158,270,428,73,46,49,74,128,931,9258000
Gary Harris,SG,26,ORL,78,76,2160,276,690,0.4,96,282,0.3404255319148936,180,408,1.363,0.46956521739130436,128,156,0.8205128205128205,42,116,158,156,56,22,74,142,776,19610714
Jalen Harris,SG,22,TOR,13,2,172,36,72,0.5,17,36,0.4722222222222222,19,36,0.528,0.6180555555555556,7,9,0.7777777777777778,3,15,18,17,8,0,14,15,96,449115
Joe Harris,SF,29,BRK,69,65,2141,357,707,0.504950495049505,211,444,0.4752252252252252,146,263,0.555,0.6541725601131542,49,63,0.7777777777777778,43,205,248,130,46,14,62,141,974,16071429
Tobias Harris,PF,28,PHI,62,62,2014,473,924,0.5119047619047619,82,208,0.3942307692307692,391,716,0.546,0.5562770562770563,182,204,0.8921568627450981,62,357,419,220,55,51,107,119,1210,34358850
Shaquille Harrison,SG,27,DEN,68,0,666,52,156,0.3333333333333333,6,32,0.1875,46,124,1.0899999999999999,0.3525641025641026,36,44,0.8181818181818182,14,82,96,50,34,10,22,66,146,915048
Josh Hart,SF,25,NOP,47,4,1349,151,344,0.438953488372093,63,193,0.32642487046632124,88,151,0.583,0.5305232558139535,69,89,0.7752808988764045,53,324,377,109,38,12,49,111,434,3491159
Isaiah Hartenstein,C,22,CLE,92,4,1118,188,342,0.5497076023391813,4,12,0.3333333333333333,184,330,1.6709999999999998,0.5555555555555556,92,142,0.647887323943662,130,232,362,110,38,78,88,208,472,1620564
Udonis Haslem,C,40,MIA,1,0,3,2,2,1.0,0,0,0.0,2,2,1.0,1.0,0,0,0.0,0,1,1,0,0,0,0,0,4,2564753
Jaxson Hayes,C,20,NOP,60,3,964,175,280,0.625,6,14,0.42857142857142855,169,266,0.635,0.6357142857142857,93,120,0.775,92,165,257,35,25,38,39,101,449,5105160
Killian Hayes,PG,19,DET,26,18,670,71,201,0.35323383084577115,20,72,0.2777777777777778,51,129,0.395,0.40298507462686567,14,17,0.8235294117647058,6,63,69,138,27,10,83,57,176,5307120
Gordon Hayward,SF,30,CHO,44,44,1496,311,658,0.4726443768996961,85,205,0.4146341463414634,226,453,0.499,0.5372340425531915,156,185,0.8432432432432433,37,221,258,181,52,14,91,74,863,28500000
Juan Hernangomez,PF,25,MIN,52,6,900,130,299,0.43478260869565216,55,168,0.3273809523809524,75,131,0.573,0.5267558528428093,60,97,0.6185567010309279,45,160,205,35,19,7,27,52,375,6493000
Willy Hernangomez,C,26,NOP,47,12,846,151,268,0.5634328358208955,1,10,0.1,150,258,0.581,0.5652985074626866,62,93,0.6666666666666666,117,217,334,50,22,23,34,68,365,1737145
Tyler Herro,SG,21,MIA,54,15,1635,307,699,0.43919885550786836,107,297,0.3602693602693603,200,402,0.498,0.5157367668097281,94,117,0.8034188034188035,25,243,268,184,35,17,101,71,815,3822240
Buddy Hield,SG,28,SAC,71,71,2433,403,992,0.40625,282,721,0.391123439667129,121,271,0.446,0.5483870967741935,88,104,0.8461538461538461,29,305,334,257,63,30,130,175,1176,24931817
George Hill,PG,34,PHI,60,34,1344,190,394,0.48223350253807107,62,160,0.3875,128,234,1.629,0.5609137055837563,80,100,0.8,32,90,122,146,46,10,62,62,522,9590602
Solomon Hill,PF,29,ATL,71,16,1513,107,298,0.35906040268456374,68,212,0.32075471698113206,39,86,0.45299999999999996,0.47315436241610737,35,46,0.7608695652173914,42,172,214,75,50,11,42,116,317,2174318
Nate Hinton,SG,21,DAL,21,0,93,15,42,0.35714285714285715,4,19,0.21052631578947367,11,23,0.478,0.40476190476190477,7,10,0.7,1,8,9,8,7,2,5,8,41,449115
Jaylen Hoard,SF,21,OKC,19,0,320,44,88,0.5,0,11,0.0,44,77,0.5710000000000001,0.5,28,41,0.6829268292682927,21,44,65,24,13,5,17,19,116,129209
Aaron Holiday,PG,24,IND,66,8,1176,170,436,0.38990825688073394,67,182,0.36813186813186816,103,254,0.406,0.46674311926605505,68,83,0.8192771084337349,15,74,89,123,46,13,66,94,475,2345640
Jrue Holiday,PG,30,MIL,59,56,1907,414,823,0.503037667071689,111,283,0.392226148409894,303,540,0.561,0.5704738760631834,107,136,0.7867647058823529,73,195,268,357,96,37,127,98,1046,25876111
Justin Holiday,SG,31,IND,72,52,2183,258,625,0.4128,173,453,0.3818984547461369,85,172,0.494,0.5512,67,85,0.788235294117647,32,224,256,119,74,41,54,135,756,5720400
Rondae Hollis-Jefferson,PF,26,POR,11,1,107,9,18,0.5,0,1,0.0,9,17,0.529,0.5,9,16,0.5625,11,15,26,13,2,4,2,15,27,502957
Richaun Holmes,C,27,SAC,61,61,1782,366,575,0.6365217391304347,2,11,0.18181818181818182,364,564,0.645,0.6382608695652174,135,170,0.7941176470588235,144,360,504,101,39,96,75,213,869,5005350
Rodney Hood,SF,28,TOR,110,10,1884,188,520,0.36153846153846153,68,226,0.3008849557522124,120,294,1.218,0.4269230769230769,48,56,0.8571428571428571,46,160,206,106,48,14,72,148,492,10047450
Al Horford,C,34,OKC,28,28,782,162,360,0.45,56,152,0.3684210526315789,106,208,0.51,0.5277777777777778,18,22,0.8181818181818182,29,159,188,94,25,26,29,48,398,27500000
Talen Horton-Tucker,SG,20,LAL,65,4,1304,224,489,0.45807770961145194,37,131,0.2824427480916031,187,358,0.522,0.49591002044989774,100,129,0.7751937984496124,25,144,169,181,63,21,105,127,585,1517981
Danuel House,SF,27,HOU,36,23,932,110,272,0.40441176470588236,54,156,0.34615384615384615,56,116,0.483,0.5036764705882353,41,63,0.6507936507936508,18,114,132,69,20,16,36,67,315,3717000
Dwight Howard,C,35,PHI,69,6,1196,178,303,0.5874587458745875,5,20,0.25,173,283,0.611,0.5957095709570958,121,210,0.5761904761904761,190,390,580,61,30,62,112,200,482,2564753
Markus Howard,SG,21,DEN,37,1,205,40,106,0.37735849056603776,18,65,0.27692307692307694,22,41,0.537,0.46226415094339623,7,9,0.7777777777777778,1,20,21,18,4,1,18,23,105,535294
Kevin Huerter,SG,22,ATL,69,49,2126,316,731,0.4322845417236662,140,386,0.3626943005181347,176,345,0.51,0.5280437756497948,50,64,0.78125,38,193,231,241,82,18,79,165,822,2761920
Elijah Hughes,SF,22,UTA,18,0,64,10,30,0.3333333333333333,8,23,0.34782608695652173,2,7,0.28600000000000003,0.4666666666666667,3,4,0.75,1,8,9,6,1,1,6,1,31,898310
De'Andre Hunter,SF,23,ATL,23,19,678,120,248,0.4838709677419355,31,95,0.3263157894736842,89,153,0.5820000000000001,0.5463709677419355,73,85,0.8588235294117647,17,93,110,44,19,12,29,59,344,7422000
Chandler Hutchison,SF,24,WAS,50,2,692,78,206,0.3786407766990291,16,44,0.36363636363636365,62,162,1.059,0.4174757281553398,42,50,0.84,12,144,156,34,24,10,40,66,214,2443440
Serge Ibaka,C,31,LAC,41,39,955,186,365,0.5095890410958904,39,115,0.3391304347826087,147,250,0.588,0.563013698630137,43,53,0.8113207547169812,73,202,275,74,9,47,44,76,454,9258000
Andre Iguodala,SF,37,MIA,63,5,1339,95,248,0.38306451612903225,60,182,0.32967032967032966,35,66,0.53,0.5040322580645161,25,38,0.6578947368421053,38,183,221,142,57,35,67,90,275,15000000
Ersan Ilyasova,PF,33,UTA,17,1,148,21,54,0.3888888888888889,18,41,0.43902439024390244,3,13,0.231,0.5555555555555556,5,5,1.0,7,22,29,4,10,3,8,29,65,1194542
Joe Ingles,SF,33,UTA,67,30,1867,275,562,0.4893238434163701,183,406,0.45073891625615764,92,156,0.59,0.652135231316726,76,90,0.8444444444444444,27,217,244,318,45,12,117,120,809,10363637
Brandon Ingram,SF,23,NOP,61,61,2093,513,1101,0.4659400544959128,143,375,0.38133333333333336,370,726,0.51,0.5308810172570391,281,320,0.878125,34,265,299,296,42,36,154,124,1450,27285000
Kyrie Irving,PG,28,BRK,54,54,1886,549,1086,0.505524861878453,152,378,0.4021164021164021,397,708,0.561,0.5755064456721916,201,218,0.9220183486238532,52,205,257,324,76,37,130,140,1451,33460350
Wesley Iwundu,SF,26,NOP,82,8,1078,68,204,0.3333333333333333,10,82,0.12195121951219512,58,122,1.427,0.35784313725490197,52,62,0.8387096774193549,30,150,180,36,30,8,38,98,198,1678854
Frank Jackson,PG,22,DET,40,6,738,134,293,0.45733788395904434,61,150,0.4066666666666667,73,143,0.51,0.5614334470989761,61,75,0.8133333333333334,15,71,86,36,15,1,34,53,390,699115
Jaren Jackson,C,21,MEM,11,4,258,53,125,0.424,17,60,0.2833333333333333,36,65,0.5539999999999999,0.492,35,42,0.8333333333333334,17,45,62,12,12,18,15,42,158,7257360
Josh Jackson,SG,23,DET,62,25,1560,296,707,0.4186704384724187,77,257,0.29961089494163423,219,450,0.48700000000000004,0.47312588401697314,159,218,0.7293577981651376,57,197,254,143,53,47,142,178,828,4767000
Justin Jackson,SF,25,MIL,68,6,1154,178,442,0.40271493212669685,72,234,0.3076923076923077,106,208,1.3579999999999999,0.4841628959276018,62,74,0.8378378378378378,32,122,154,104,30,4,64,64,490,5109637
Reggie Jackson,SG,30,LAC,67,43,1544,263,585,0.4495726495726496,122,282,0.4326241134751773,141,303,0.465,0.5538461538461539,67,82,0.8170731707317073,24,168,192,205,41,7,74,127,715,2331593
Justin James,SF,24,SAC,36,0,310,52,111,0.46846846846846846,14,38,0.3684210526315789,38,73,0.521,0.5315315315315315,21,36,0.5833333333333334,9,21,30,22,8,3,15,23,139,1517981
LeBron James,PG,36,LAL,45,45,1504,422,823,0.5127582017010935,104,285,0.3649122807017544,318,538,0.591,0.5759416767922235,178,255,0.6980392156862745,29,317,346,350,48,25,168,70,1126,39219566
Mike James,PG,30,BRK,13,1,236,34,92,0.3695652173913043,11,31,0.3548387096774194,23,61,0.377,0.42934782608695654,21,27,0.7777777777777778,3,29,32,54,6,1,20,10,100,237648
DaQuan Jeffries,SG,23,HOU,62,10,986,100,240,0.4166666666666667,40,134,0.29850746268656714,60,106,1.7080000000000002,0.5,14,16,0.875,38,104,142,44,30,20,28,96,254,1445697
Ty Jerome,SG,23,OKC,33,1,788,128,287,0.445993031358885,71,168,0.4226190476190476,57,119,0.479,0.5696864111498258,26,34,0.7647058823529411,10,81,91,120,20,6,47,61,353,2303040
Isaiah Joe,SG,21,PHI,41,1,383,48,133,0.3609022556390977,39,106,0.36792452830188677,9,27,0.33299999999999996,0.5075187969924813,18,24,0.75,6,30,36,20,12,4,11,34,153,898310
Alize Johnson,PF,24,BRK,18,0,189,40,68,0.5882352941176471,1,6,0.16666666666666666,39,62,0.629,0.5955882352941176,13,13,1.0,27,63,90,14,5,5,9,16,94,621587
Cameron Johnson,PF,24,PHO,60,11,1437,203,483,0.42028985507246375,117,335,0.3492537313432836,86,148,0.581,0.5414078674948241,50,59,0.847457627118644,33,166,199,86,37,16,40,85,573,4235160
James Johnson,PF,33,NOP,102,24,2086,292,654,0.44648318042813456,62,240,0.25833333333333336,230,414,1.6840000000000002,0.4938837920489297,90,152,0.5921052631578947,64,290,354,196,84,84,110,240,736,16047100
Keldon Johnson,SF,21,SAS,69,67,1968,338,705,0.4794326241134752,60,181,0.3314917127071823,278,524,0.531,0.5219858156028369,145,196,0.7397959183673469,93,319,412,121,40,24,78,142,881,2048040
Stanley Johnson,PF,24,TOR,61,13,1006,89,233,0.38197424892703863,45,137,0.3284671532846715,44,96,0.45799999999999996,0.47854077253218885,44,55,0.8,29,124,153,89,52,18,54,116,267,3804150
Tyler Johnson,SG,28,BRK,39,3,684,72,183,0.39344262295081966,48,132,0.36363636363636365,24,51,0.47100000000000003,0.5245901639344263,18,21,0.8571428571428571,6,71,77,47,14,0,17,43,210,2028594
Nikola Jokic,C,25,DEN,72,72,2488,732,1293,0.5661252900232019,92,237,0.3881856540084388,640,1056,0.606,0.6017014694508894,342,394,0.868020304568528,205,575,780,599,95,48,222,192,1898,29542010
Damian Jones,C,25,SAC,78,20,1094,140,206,0.6796116504854369,2,10,0.2,138,196,2.86,0.6844660194174758,84,116,0.7241379310344828,72,170,242,58,22,58,52,154,366,1487284
Derrick Jones,SF,23,POR,58,43,1318,147,304,0.48355263157894735,43,136,0.3161764705882353,104,168,0.619,0.5542763157894737,59,91,0.6483516483516484,77,128,205,47,37,54,32,127,396,9258000
Mason Jones,SG,22,PHI,64,2,668,104,246,0.42276422764227645,48,132,0.36363636363636365,56,114,1.542,0.5203252032520326,80,128,0.625,14,96,110,84,14,2,58,48,336,424544
Tre Jones,PG,21,SAS,37,1,269,37,78,0.47435897435897434,3,5,0.6,34,73,0.466,0.4935897435897436,17,19,0.8947368421052632,8,13,21,39,8,0,13,13,94,898310
Tyus Jones,PG,24,MEM,70,9,1222,178,413,0.43099273607748184,45,140,0.32142857142857145,133,273,0.48700000000000004,0.4854721549636804,41,45,0.9111111111111111,21,119,140,259,64,6,48,31,442,8817143
DeAndre Jordan,C,32,BRK,57,43,1246,190,249,0.7630522088353414,0,1,0.0,190,248,0.7659999999999999,0.7630522088353414,46,92,0.5,117,310,427,93,17,65,85,116,426,10375678
Cory Joseph,PG,29,DET,126,26,2892,400,852,0.4694835680751174,90,264,0.3409090909090909,310,588,1.583,0.5223004694835681,144,176,0.8181818181818182,70,248,318,426,122,36,158,278,1034,12600000
Mfiondu Kabengele,PF,23,CLE,78,0,560,66,178,0.3707865168539326,26,100,0.26,40,78,1.4700000000000002,0.4438202247191011,32,40,0.8,24,96,120,34,16,26,30,72,190,2432353
Frank Kaminsky,C,27,PHO,47,13,715,121,257,0.4708171206225681,31,85,0.36470588235294116,90,172,0.523,0.5311284046692607,37,60,0.6166666666666667,36,152,188,79,14,17,22,70,310,1737145
Enes Kanter,C,28,POR,72,35,1758,339,561,0.6042780748663101,1,4,0.25,338,557,0.607,0.6051693404634582,127,164,0.774390243902439,284,511,795,84,33,48,78,168,806,5005350
Luke Kennard,SG,24,LAC,63,17,1232,197,414,0.4758454106280193,100,224,0.44642857142857145,97,190,0.511,0.5966183574879227,26,31,0.8387096774193549,15,146,161,104,23,9,48,91,520,5273826
Louis King,SF,21,SAC,6,1,85,17,34,0.5,4,11,0.36363636363636365,13,23,0.565,0.5588235294117647,6,6,1.0,5,13,18,9,7,3,4,9,44,49222
Maxi Kleber,PF,29,DAL,50,40,1341,116,275,0.4218181818181818,87,212,0.41037735849056606,29,63,0.46,0.58,34,37,0.918918918918919,47,213,260,68,24,35,30,105,353,8325000
Nathan Knight,PF,23,ATL,33,0,279,37,100,0.37,6,33,0.18181818181818182,31,67,0.46299999999999997,0.4,44,55,0.8,27,45,72,8,9,10,15,22,124,522989
Kevin Knox,SF,21,NYK,42,0,464,56,143,0.3916083916083916,35,89,0.39325842696629215,21,54,0.389,0.513986013986014,16,20,0.8,10,51,61,19,12,6,17,37,163,4588680
John Konchar,SG,24,MEM,43,0,575,69,138,0.5,21,56,0.375,48,82,0.585,0.5760869565217391,25,30,0.8333333333333334,35,93,128,47,30,9,18,40,184,2100000
Furkan Korkmaz,SG,23,PHI,55,11,1062,170,424,0.4009433962264151,101,269,0.3754646840148699,69,155,0.445,0.5200471698113207,60,82,0.7317073170731707,17,96,113,82,49,9,46,64,501,1762796
Luke Kornet,C,25,BOS,62,4,696,88,202,0.43564356435643564,30,118,0.2542372881355932,58,84,2.124,0.5099009900990099,6,12,0.5,28,106,134,48,8,64,14,40,212,2250000
Rodions Kurucs,SF,22,MIL,42,0,250,22,64,0.34375,12,42,0.2857142857142857,10,22,1.455,0.4375,6,8,0.75,10,36,46,20,18,8,26,32,62,1780152
Kyle Kuzma,SF,25,LAL,68,32,1954,335,757,0.4425363276089828,137,380,0.3605263157894737,198,377,0.525,0.5330250990752973,67,97,0.6907216494845361,108,309,417,127,35,41,113,121,874,3562178
Anthony Lamb,SF,23,HOU,24,3,415,46,118,0.3898305084745763,23,71,0.323943661971831,23,47,0.489,0.4872881355932203,18,21,0.8571428571428571,27,43,70,23,6,5,19,34,133,215330
Jeremy Lamb,SG,28,IND,36,8,765,120,276,0.43478260869565216,52,128,0.40625,68,148,0.45899999999999996,0.5289855072463768,71,75,0.9466666666666667,25,106,131,53,34,23,22,72,363,10500000
Romeo Langford,SG,21,BOS,18,4,283,21,59,0.3559322033898305,5,18,0.2777777777777778,16,41,0.39,0.3983050847457627,9,12,0.75,12,23,35,13,6,5,10,24,56,3631200
Zach LaVine,SG,25,CHI,58,58,2034,569,1123,0.5066785396260017,200,477,0.4192872117400419,369,646,0.5710000000000001,0.5957257346393589,253,298,0.8489932885906041,36,253,289,282,46,27,203,138,1591,19500000
Jake Layman,SF,26,MIN,45,11,627,91,184,0.4945652173913043,23,78,0.2948717948717949,68,106,0.642,0.5570652173913043,26,37,0.7027027027027027,13,54,67,28,29,19,26,44,231,3761085
TJ Leaf,PF,23,POR,7,0,35,5,10,0.5,0,0,0.0,5,10,0.5,0.5,2,2,1.0,0,5,5,1,2,1,2,1,12,4431423
Jalen Lecque,PG,20,IND,4,0,12,1,9,0.1111111111111111,0,1,0.0,1,8,0.125,0.1111111111111111,3,3,1.0,2,3,5,2,0,0,0,0,5,1517981
Damion Lee,SG,28,GSW,57,1,1079,128,274,0.46715328467153283,77,194,0.39690721649484534,51,80,0.638,0.6076642335766423,40,44,0.9090909090909091,22,158,180,73,38,8,30,89,373,1762796
Saben Lee,PG,21,DET,48,7,781,99,210,0.4714285714285714,8,23,0.34782608695652173,91,187,0.48700000000000004,0.49047619047619045,61,89,0.6853932584269663,20,77,97,174,32,13,55,76,267,516836
Alex Len,C,27,WAS,128,84,1958,342,556,0.6151079136690647,16,50,0.32,326,506,1.7910000000000001,0.6294964028776978,146,232,0.6293103448275862,156,364,520,98,40,128,110,254,846,3970648
Kawhi Leonard,SF,29,LAC,52,52,1773,465,908,0.512114537444934,101,254,0.39763779527559057,364,654,0.557,0.5677312775330396,261,295,0.8847457627118644,55,282,337,269,81,21,105,82,1292,34379100
Meyers Leonard,C,28,MIA,3,2,29,3,7,0.42857142857142855,3,7,0.42857142857142855,0,0,0.0,0.6428571428571429,1,2,0.5,0,7,7,2,0,0,2,5,10,9400000
Caris LeVert,SG,26,IND,94,78,2972,718,1628,0.44103194103194104,168,516,0.32558139534883723,550,1112,1.47,0.4926289926289926,292,360,0.8111111111111111,66,362,428,490,132,60,204,210,1896,16203704
Kira Lewis,PG,19,NOP,54,0,904,130,337,0.3857566765578635,40,120,0.3333333333333333,90,217,0.415,0.44510385756676557,43,51,0.8431372549019608,12,59,71,124,38,10,34,88,343,3640200
Damian Lillard,PG,30,POR,67,67,2398,602,1334,0.4512743628185907,275,704,0.390625,327,630,0.519,0.5543478260869565,449,484,0.9276859504132231,32,251,283,505,62,17,203,102,1928,31626953
Nassir Little,PF,20,POR,48,2,640,78,167,0.46706586826347307,28,80,0.35,50,87,0.575,0.5508982035928144,36,45,0.8,32,96,128,23,5,13,18,51,220,2210640
Kevon Looney,C,24,GSW,61,34,1161,108,197,0.5482233502538071,4,17,0.23529411764705882,104,180,0.578,0.5583756345177665,31,48,0.6458333333333334,117,205,322,119,21,22,37,136,251,4821429
Brook Lopez,C,32,MIL,70,70,1902,322,640,0.503125,95,281,0.33807829181494664,227,359,0.632,0.57734375,120,142,0.8450704225352113,104,243,347,50,40,103,64,149,859,12697675
Robin Lopez,C,32,WAS,71,9,1354,269,425,0.6329411764705882,5,18,0.2777777777777778,264,407,0.649,0.6388235294117647,99,137,0.7226277372262774,141,131,272,55,15,44,75,109,642,7300000
Didi Louzada,SF,21,NOP,3,0,56,3,13,0.23076923076923078,2,8,0.25,1,5,0.2,0.3076923076923077,0,0,0.0,1,2,3,3,2,0,3,5,8,123056
Kevin Love,PF,32,CLE,25,25,622,103,252,0.4087301587301587,57,156,0.36538461538461536,46,96,0.479,0.5218253968253969,42,51,0.8235294117647058,17,169,186,63,16,2,38,26,305,31258256
Kyle Lowry,PG,34,TOR,46,46,1601,260,596,0.436241610738255,131,331,0.3957703927492447,129,265,0.48700000000000004,0.5461409395973155,140,160,0.875,35,212,247,338,45,14,126,143,791,30500000
Timothe Luwawu,SF,25,BRK,58,7,1050,130,356,0.3651685393258427,75,239,0.3138075313807531,55,117,0.47,0.4705056179775281,35,43,0.813953488372093,28,101,129,69,33,6,43,99,370,1824003
Trey Lyles,PF,25,SAS,23,9,358,43,90,0.4777777777777778,14,40,0.35,29,50,0.58,0.5555555555555556,15,23,0.6521739130434783,9,77,86,14,6,1,6,13,115,5500000
Will Magnay,C,22,NOP,1,0,3,0,1,0.0,0,1,0.0,0,0,0.0,0.0,0,0,0.0,0,0,0,0,0,0,1,1,0,341481
Thon Maker,C,23,CLE,8,0,76,10,18,0.5555555555555556,0,2,0.0,10,16,0.625,0.5555555555555556,10,11,0.9090909090909091,8,10,18,4,2,4,3,7,30,1737145
Theo Maledon,PG,19,OKC,65,49,1778,226,614,0.36807817589576547,105,313,0.3354632587859425,121,301,0.402,0.4535830618892508,101,135,0.7481481481481481,25,186,211,227,56,11,141,126,658,2000000
Karim Mane,PG,20,ORL,10,0,88,3,13,0.23076923076923078,1,2,0.5,2,11,0.182,0.2692307692307692,4,5,0.8,1,13,14,4,0,2,3,10,11,344557
Terance Mann,SG,24,LAC,67,10,1263,178,350,0.5085714285714286,38,91,0.4175824175824176,140,259,0.541,0.5628571428571428,78,94,0.8297872340425532,56,186,242,104,29,13,40,126,472,1517981
Nico Mannion,PG,19,GSW,30,1,364,39,114,0.34210526315789475,22,60,0.36666666666666664,17,54,0.315,0.43859649122807015,23,28,0.8214285714285714,6,40,46,70,16,1,31,29,123,449115
Boban Marjanovic,C,32,DAL,33,3,271,62,122,0.5081967213114754,1,8,0.125,61,114,0.535,0.5122950819672131,31,38,0.8157894736842105,47,81,128,10,2,6,12,29,156,3500000
Lauri Markkanen,PF,23,CHI,51,26,1317,250,521,0.4798464491362764,119,296,0.40202702702702703,131,225,0.5820000000000001,0.5940499040307101,76,92,0.8260869565217391,35,233,268,45,26,15,52,75,695,6731508
Naji Marshall,SF,23,NOP,32,10,700,82,209,0.3923444976076555,29,83,0.3493975903614458,53,126,0.42100000000000004,0.46172248803827753,53,75,0.7066666666666667,15,133,148,88,26,10,38,58,246,538391
Caleb Martin,SF,25,CHO,53,3,818,96,256,0.375,31,125,0.248,65,131,0.496,0.435546875,41,64,0.640625,31,110,141,67,37,12,33,62,264,1517981
Cody Martin,SF,25,CHO,52,10,849,83,188,0.44148936170212766,16,58,0.27586206896551724,67,130,0.515,0.48404255319148937,25,43,0.5813953488372093,52,109,161,86,37,12,40,52,207,1517981
Jeremiah Martin,PG,24,CLE,9,0,75,9,33,0.2727272727272727,3,12,0.25,6,21,0.28600000000000003,0.3181818181818182,1,5,0.2,2,5,7,4,5,2,6,1,22,58452
Kelan Martin,SF,25,IND,35,0,322,62,138,0.4492753623188406,24,60,0.4,38,78,0.48700000000000004,0.5362318840579711,9,10,0.9,18,60,78,17,10,10,16,35,157,1445697
KJ Martin,SF,20,HOU,45,8,1068,162,318,0.5094339622641509,35,96,0.3645833333333333,127,222,0.5720000000000001,0.5644654088050315,60,84,0.7142857142857143,73,169,242,48,30,41,38,89,419,898310
Frank Mason,PG,26,ORL,4,1,79,9,24,0.375,2,5,0.4,7,19,0.368,0.4166666666666667,5,7,0.7142857142857143,3,9,12,12,0,0,5,7,25,39989
Garrison Mathews,SG,24,WAS,64,24,1038,97,237,0.4092827004219409,76,198,0.3838383838383838,21,39,0.5379999999999999,0.569620253164557,84,95,0.8842105263157894,16,71,87,26,29,7,10,106,354,688052
Dakota Mathias,SG,25,PHI,8,2,123,19,48,0.3958333333333333,8,26,0.3076923076923077,11,22,0.5,0.4791666666666667,2,6,0.3333333333333333,1,6,7,13,1,3,1,7,48,86132
Wesley Matthews,SG,34,LAL,58,10,1130,89,252,0.3531746031746032,66,197,0.3350253807106599,23,55,0.418,0.48412698412698413,35,41,0.8536585365853658,20,73,93,54,38,17,26,80,279,3623000
Tyrese Maxey,SG,20,PHI,61,8,935,198,429,0.46153846153846156,31,103,0.30097087378640774,167,326,0.512,0.4976689976689977,61,70,0.8714285714285714,11,93,104,120,26,13,41,79,488,2478840
Skylar Mays,SG,23,ATL,33,0,269,44,98,0.4489795918367347,14,40,0.35,30,58,0.517,0.5204081632653061,22,25,0.88,10,25,35,30,14,2,9,15,124,532218
Patrick McCaw,SF,25,TOR,5,0,33,1,1,1.0,0,0,0.0,1,1,1.0,1.0,3,3,1.0,1,2,3,4,2,0,0,6,5,4000000
CJ McCollum,SG,29,POR,47,47,1600,405,884,0.4581447963800905,169,420,0.4023809523809524,236,464,0.509,0.5537330316742082,108,133,0.8120300751879699,30,155,185,223,44,21,65,87,1087,29354152
TJ McConnell,PG,28,IND,69,3,1796,274,490,0.5591836734693878,15,48,0.3125,259,442,0.586,0.5744897959183674,33,48,0.6875,55,201,256,456,128,23,135,113,596,3500000
Jaden McDaniels,PF,20,MIN,63,27,1511,164,367,0.44686648501362397,72,198,0.36363636363636365,92,169,0.544,0.5449591280653951,27,45,0.6,52,180,232,71,35,60,47,172,427,1964760
Jalen McDaniels,SF,23,CHO,47,18,904,133,284,0.46830985915492956,35,105,0.3333333333333333,98,179,0.547,0.5299295774647887,45,64,0.703125,45,124,169,53,28,19,45,95,346,1517981
Doug McDermott,PF,29,IND,66,29,1619,354,665,0.5323308270676692,111,286,0.3881118881118881,243,379,0.6409999999999999,0.6157894736842106,80,98,0.8163265306122449,60,161,221,85,20,6,53,117,899,7333333
Sean McDermott,SF,24,MEM,18,0,158,13,33,0.3939393939393939,5,22,0.22727272727272727,8,11,0.727,0.4696969696969697,8,8,1.0,6,13,19,4,2,3,4,8,39,449115
JaVale McGee,C,33,DEN,92,4,1356,288,564,0.5106382978723404,10,48,0.20833333333333334,278,516,1.596,0.5195035460992907,88,134,0.6567164179104478,154,324,478,78,38,108,120,242,674,4200000
Rodney McGruder,SG,29,DET,16,2,194,37,70,0.5285714285714286,11,24,0.4583333333333333,26,46,0.565,0.6071428571428571,6,8,0.75,8,14,22,16,8,1,7,12,91,5192307
Alfonzo McKinnie,SF,28,LAL,39,0,258,48,93,0.5161290322580645,16,39,0.41025641025641024,32,54,0.593,0.6021505376344086,10,18,0.5555555555555556,22,32,54,6,7,0,5,26,122,1762796
Jordan McLaughlin,PG,24,MIN,51,2,938,100,242,0.4132231404958678,33,92,0.358695652173913,67,150,0.447,0.48140495867768596,23,30,0.7666666666666667,21,87,108,193,51,6,51,44,256,503760
Ben McLemore,SG,27,LAL,106,10,1810,270,730,0.3698630136986301,194,560,0.3464285714285714,76,170,1.359,0.5027397260273972,78,106,0.7358490566037735,30,170,200,78,46,18,84,176,812,2893630
Nicolo Melli,PF,30,DAL,90,8,1132,92,282,0.3262411347517731,46,170,0.27058823529411763,46,112,1.216,0.4078014184397163,38,50,0.76,58,186,244,88,28,6,24,116,268,3897436
De'Anthony Melton,PG,22,MEM,52,1,1045,172,393,0.43765903307888043,87,211,0.41232227488151657,85,182,0.467,0.5483460559796438,41,51,0.803921568627451,30,131,161,132,60,31,66,85,472,9571712
Sam Merrill,SG,24,MIL,30,2,233,32,72,0.4444444444444444,21,47,0.44680851063829785,11,25,0.44,0.5902777777777778,4,4,1.0,6,24,30,21,8,1,10,17,89,898310
Chimezie Metu,C,23,SAC,36,6,488,91,179,0.5083798882681564,13,37,0.35135135135135137,78,142,0.5489999999999999,0.5446927374301676,31,43,0.7209302325581395,31,81,112,28,14,18,29,59,226,910895
Khris Middleton,SF,29,MIL,68,68,2269,511,1074,0.4757914338919926,151,365,0.4136986301369863,360,709,0.508,0.5460893854748603,212,236,0.8983050847457628,54,352,406,370,74,9,178,160,1385,33051724
Darius Miller,SF,30,OKC,18,0,197,22,48,0.4583333333333333,17,42,0.40476190476190477,5,6,0.833,0.6354166666666666,12,12,1.0,2,22,24,21,13,5,8,13,73,7000000
Patrick Mills,PG,32,SAS,68,1,1685,252,611,0.41243862520458263,161,429,0.3752913752913753,91,182,0.5,0.544189852700491,71,78,0.9102564102564102,18,98,116,162,42,3,66,81,736,13535714
Paul Millsap,PF,35,DEN,56,36,1162,191,401,0.4763092269326683,49,143,0.34265734265734266,142,258,0.55,0.5374064837905237,71,98,0.7244897959183674,76,186,262,98,51,36,51,111,502,10000000
Shake Milton,SG,24,PHI,63,4,1461,300,667,0.4497751124437781,71,203,0.3497536945812808,229,464,0.494,0.5029985007496252,146,176,0.8295454545454546,33,115,148,193,39,18,103,130,817,12888889
Shake Milton,SG,24,PHI,63,4,1461,300,667,0.4497751124437781,71,203,0.3497536945812808,229,464,0.494,0.5029985007496252,146,176,0.8295454545454546,33,115,148,193,39,18,103,130,817,1701593
Donovan Mitchell,PG,24,UTA,53,53,1771,478,1091,0.4381301558203483,178,461,0.38611713665943603,300,630,0.47600000000000003,0.5197066911090742,267,316,0.8449367088607594,50,185,235,277,52,15,147,117,1401,5195501
Adam Mokoka,SG,22,CHI,14,0,56,7,19,0.3684210526315789,1,10,0.1,6,9,0.667,0.39473684210526316,0,1,0.0,1,4,5,5,2,1,5,5,15,449115
Malik Monk,SG,22,CHO,42,0,878,173,399,0.43358395989974935,85,212,0.4009433962264151,88,187,0.47100000000000003,0.5401002506265664,59,72,0.8194444444444444,14,87,101,87,19,4,55,47,490,5345687
E'Twaun Moore,SG,31,PHO,27,1,389,55,121,0.45454545454545453,11,35,0.3142857142857143,44,86,0.512,0.5,12,14,0.8571428571428571,14,31,45,40,15,5,23,32,133,2331593
Ja Morant,PG,21,MEM,63,63,2053,430,957,0.44932079414838033,73,241,0.3029045643153527,357,716,0.499,0.48746081504702193,271,372,0.728494623655914,59,193,252,465,57,13,203,87,1204,9166800
Juwan Morgan,PF,23,UTA,29,0,147,14,30,0.4666666666666667,4,13,0.3076923076923077,10,17,0.588,0.5333333333333333,3,7,0.42857142857142855,9,19,28,9,4,1,4,21,35,1517981
Marcus Morris,PF,31,LAC,57,29,1502,276,584,0.4726027397260274,140,296,0.47297297297297297,136,288,0.47200000000000003,0.5924657534246576,73,89,0.8202247191011236,35,199,234,58,34,15,57,117,765,14883721
Markieff Morris,PF,31,LAL,61,27,1200,153,378,0.40476190476190477,65,209,0.31100478468899523,88,169,0.521,0.49074074074074076,36,50,0.72,48,218,266,73,22,19,54,105,407,2331593
Monte Morris,PG,25,DEN,47,13,1196,186,387,0.4806201550387597,51,134,0.3805970149253731,135,253,0.534,0.5465116279069767,58,73,0.7945205479452054,11,85,96,150,34,13,34,48,481,1723707
Mychal Mulder,PG,26,GSW,60,6,766,119,265,0.4490566037735849,85,214,0.397196261682243,34,51,0.667,0.6094339622641509,14,22,0.6363636363636364,8,52,60,26,12,12,16,56,337,1517981
Dejounte Murray,PG,24,SAS,67,67,2139,441,974,0.4527720739219713,63,199,0.3165829145728643,378,775,0.488,0.4851129363449692,106,134,0.7910447761194029,58,415,473,363,101,7,117,135,1051,14286000
Jamal Murray,PG,23,DEN,48,48,1704,378,792,0.4772727272727273,129,316,0.40822784810126583,249,476,0.523,0.5587121212121212,133,153,0.869281045751634,37,157,194,231,64,13,108,95,1018,27285000
Mike Muscala,C,29,OKC,35,0,645,119,267,0.44569288389513106,68,184,0.3695652173913043,51,83,0.614,0.5730337078651685,33,36,0.9166666666666666,19,113,132,28,8,11,21,54,339,2283034
Sviatoslav Mykhailiuk,SG,23,OKC,132,28,2648,416,1012,0.41106719367588934,210,628,0.3343949044585987,206,384,1.598,0.5148221343873518,76,100,0.76,48,278,326,220,102,24,176,126,1118,1663861
Abdel Nader,SF,27,PHO,24,0,355,57,116,0.49137931034482757,18,43,0.4186046511627907,39,73,0.534,0.5689655172413793,28,37,0.7567567567567568,7,55,62,19,10,9,19,34,160,1752950
Larry Nance,PF,28,CLE,35,27,1091,128,272,0.47058823529411764,41,114,0.35964912280701755,87,158,0.551,0.5459558823529411,30,49,0.6122448979591837,54,181,235,107,61,17,55,72,327,11709091
Aaron Nesmith,SF,21,BOS,46,1,669,78,178,0.43820224719101125,40,108,0.37037037037037035,38,70,0.5429999999999999,0.550561797752809,22,28,0.7857142857142857,28,99,127,23,15,9,23,87,218,3458400
Raul Neto,PG,28,WAS,64,22,1403,209,447,0.46756152125279643,64,164,0.3902439024390244,145,283,0.512,0.5391498881431768,75,85,0.8823529411764706,28,128,156,146,73,6,53,109,557,1882867
Georges Niang,PF,27,UTA,72,10,1154,177,405,0.43703703703703706,124,292,0.4246575342465753,53,113,0.469,0.5901234567901235,22,23,0.9565217391304348,28,148,176,59,25,8,51,116,500,1783557
Zeke Nnaji,PF,20,DEN,42,1,397,50,104,0.4807692307692308,24,59,0.4067796610169492,26,45,0.578,0.5961538461538461,12,15,0.8,14,51,65,10,8,4,7,29,136,2379840
Nerlens Noel,C,26,NYK,64,41,1547,137,223,0.6143497757847534,0,3,0.0,137,220,0.623,0.6143497757847534,50,70,0.7142857142857143,142,266,408,46,70,141,65,176,324,5000000
Jaylen Nowell,SG,21,MIN,42,0,759,142,335,0.42388059701492536,50,150,0.3333333333333333,92,185,0.49700000000000005,0.49850746268656715,45,55,0.8181818181818182,19,76,95,62,22,12,28,72,379,1517981
Frank Ntilikina,PG,22,NYK,33,4,322,29,79,0.3670886075949367,23,48,0.4791666666666667,6,31,0.19399999999999998,0.5126582278481012,8,18,0.4444444444444444,6,25,31,19,18,4,11,45,89,6176578
Kendrick Nunn,PG,25,MIA,56,44,1650,319,658,0.4848024316109423,122,320,0.38125,197,338,0.583,0.5775075987841946,56,60,0.9333333333333333,21,158,179,148,52,14,80,108,816,1663861
James Nunnally,SF,30,NOP,9,0,48,5,13,0.38461538461538464,4,12,0.3333333333333333,1,1,1.0,0.5384615384615384,1,2,0.5,2,7,9,3,0,0,2,1,15,107674
Jusuf Nurkic,C,26,POR,37,37,880,171,333,0.5135135135135135,12,30,0.4,159,303,0.525,0.5315315315315315,70,113,0.6194690265486725,86,246,332,125,38,39,73,103,424,12888889
David Nwaba,SF,28,HOU,30,9,679,106,218,0.48623853211009177,17,63,0.2698412698412698,89,155,0.574,0.5252293577981652,47,68,0.6911764705882353,40,78,118,31,30,21,17,60,276,1824003
Jordan Nwora,SF,22,MIL,30,2,274,62,135,0.45925925925925926,28,62,0.45161290322580644,34,73,0.466,0.562962962962963,19,25,0.76,9,51,60,7,16,7,24,22,171,898310
Royce O'Neale,SF,27,UTA,71,71,2241,175,394,0.44416243654822335,107,278,0.38489208633093525,68,116,0.586,0.5799492385786802,39,46,0.8478260869565217,88,397,485,181,57,32,83,182,496,8500000
Semi Ojeleye,PF,26,BOS,56,15,950,89,221,0.40271493212669685,58,158,0.3670886075949367,31,63,0.49200000000000005,0.5339366515837104,24,32,0.75,31,116,147,37,17,0,21,56,260,1752950
Jahlil Okafor,C,25,DET,27,2,347,63,102,0.6176470588235294,2,9,0.2222222222222222,61,93,0.6559999999999999,0.6274509803921569,17,24,0.7083333333333334,23,43,66,13,6,5,21,39,145,1882867
Chuma Okeke,PF,22,ORL,45,19,1133,135,324,0.4166666666666667,49,141,0.3475177304964539,86,183,0.47,0.49228395061728397,30,40,0.75,42,139,181,101,48,22,38,48,349,3121080
Josh Okogie,SG,22,MIN,59,37,1197,102,254,0.4015748031496063,29,108,0.26851851851851855,73,146,0.5,0.45866141732283466,83,108,0.7685185185185185,63,93,156,63,54,28,43,123,316,2651040
Onyeka Okongwu,C,20,ATL,50,4,601,96,149,0.6442953020134228,0,3,0.0,96,146,0.6579999999999999,0.6442953020134228,36,57,0.631578947368421,62,101,163,18,23,33,29,100,228,5813640
Isaac Okoro,SG,20,CLE,67,67,2173,235,559,0.4203935599284436,62,214,0.2897196261682243,173,345,0.501,0.47584973166368516,114,157,0.7261146496815286,68,138,206,128,62,24,86,185,646,6400920
KZ Okpala,PF,21,MIA,37,9,447,36,96,0.375,12,50,0.24,24,46,0.522,0.4375,8,15,0.5333333333333333,21,47,68,19,10,11,15,59,92,1517981
Victor Oladipo,SG,28,MIA,66,66,2160,470,1152,0.4079861111111111,156,478,0.3263598326359833,314,674,1.863,0.4756944444444444,208,276,0.7536231884057971,24,296,320,302,92,28,166,162,1304,21000000
Cameron Oliver,SF,24,HOU,4,0,87,19,33,0.5757575757575758,4,13,0.3076923076923077,15,20,0.75,0.6363636363636364,1,4,0.25,5,16,21,5,2,4,3,11,43,43070
Kelly Olynyk,PF,29,HOU,140,124,3994,674,1394,0.4835007173601148,252,736,0.3423913043478261,422,658,1.9229999999999998,0.5738880918220947,290,350,0.8285714285714286,174,804,978,406,158,84,252,414,1890,12819650
Miye Oni,SG,23,UTA,54,0,519,35,99,0.35353535353535354,30,88,0.3409090909090909,5,11,0.455,0.5050505050505051,5,6,0.8333333333333334,23,61,84,28,11,8,16,61,105,1517981
Cedi Osman,SF,25,CLE,59,26,1510,219,586,0.37372013651877134,99,324,0.3055555555555556,120,262,0.45799999999999996,0.45819112627986347,76,95,0.8,38,163,201,174,53,9,80,119,613,8840580
Daniel Oturu,C,21,LAC,30,0,161,22,52,0.4230769230769231,1,5,0.2,21,47,0.447,0.4326923076923077,9,12,0.75,21,27,48,10,4,7,9,24,54,898310
Kelly Oubre,SF,25,GSW,55,50,1687,318,724,0.43922651933701656,90,285,0.3157894736842105,228,439,0.519,0.5013812154696132,123,177,0.6949152542372882,82,247,329,73,57,42,70,121,849,14375000
Jabari Parker,PF,25,BOS,26,0,330,60,110,0.5454545454545454,4,22,0.18181818181818182,56,88,1.935,0.5636363636363636,20,26,0.7692307692307693,20,64,84,22,2,10,20,26,144,6930729
Eric Paschall,PF,24,GSW,40,2,695,148,298,0.4966442953020134,18,54,0.3333333333333333,130,244,0.5329999999999999,0.5268456375838926,67,94,0.7127659574468085,28,100,128,51,12,7,43,68,381,1517981
Anzejs Pasecniks,C,25,WAS,1,0,6,0,1,0.0,0,1,0.0,0,0,0.0,0.0,0,0,0.0,1,0,1,1,0,0,5,2,0,374297
Patrick Patterson,PF,31,LAC,38,5,582,72,165,0.43636363636363634,40,112,0.35714285714285715,32,53,0.604,0.5575757575757576,13,17,0.7647058823529411,19,56,75,29,14,8,11,45,197,3814771
Justin Patton,C,23,HOU,13,6,247,29,70,0.4142857142857143,9,34,0.2647058823529412,20,36,0.556,0.4785714285714286,3,4,0.75,14,35,49,14,12,14,4,34,70,267623
Chris Paul,PG,35,PHO,70,70,2199,439,879,0.49943117178612056,102,258,0.3953488372093023,337,621,0.5429999999999999,0.5574516496018203,169,181,0.9337016574585635,25,287,312,622,99,19,156,166,1149,41358814
Cameron Payne,PG,26,PHO,60,1,1079,191,395,0.4835443037974684,73,166,0.4397590361445783,118,229,0.515,0.5759493670886076,50,56,0.8928571428571429,16,128,144,217,36,16,60,97,505,1977011
Elfrid Payton,PG,26,NYK,63,63,1484,269,622,0.432475884244373,28,98,0.2857142857142857,241,524,0.46,0.454983922829582,73,107,0.6822429906542056,64,152,216,203,47,9,103,116,639,4767000
Gary Payton II,PG,28,GSW,10,0,40,10,13,0.7692307692307693,2,4,0.5,8,9,0.889,0.8461538461538461,3,4,0.75,2,9,11,1,6,1,1,8,25,249864
Norvel Pelle,C,27,NYK,26,0,168,16,30,0.5333333333333333,0,0,0.0,16,30,1.6760000000000002,0.5333333333333333,8,12,0.6666666666666666,12,26,38,4,2,18,6,28,40,1014905
Reggie Perry,PF,20,BRK,26,0,211,32,78,0.41025641025641024,4,21,0.19047619047619047,28,57,0.491,0.4358974358974359,10,13,0.7692307692307693,27,46,73,14,6,6,15,40,78,489148
Theo Pinson,SG,25,NYK,17,0,34,1,9,0.1111111111111111,0,8,0.0,1,1,1.0,0.1111111111111111,0,0,0.0,0,5,5,1,0,0,1,4,2,802182
Mason Plumlee,C,30,DET,56,56,1499,234,381,0.6141732283464567,0,7,0.0,234,374,0.626,0.6141732283464567,113,169,0.6686390532544378,145,374,519,202,43,50,105,186,581,8000000
Jakob Poeltl,C,25,SAS,69,51,1845,265,430,0.6162790697674418,0,0,0.0,265,430,0.616,0.6162790697674418,63,124,0.5080645161290323,219,328,547,134,47,123,83,172,593,8101852
Vincent Poirier,C,27,PHI,10,0,39,3,12,0.25,0,1,0.0,3,11,0.273,0.25,2,6,0.3333333333333333,6,8,14,2,0,3,4,8,8,2619207
Aleksej Pokusevski,PF,19,OKC,45,28,1090,139,408,0.34068627450980393,58,207,0.28019323671497587,81,201,0.40299999999999997,0.4117647058823529,31,42,0.7380952380952381,30,182,212,97,20,42,99,58,367,2964840
Jordan Poole,SG,21,GSW,51,7,988,205,474,0.43248945147679324,97,276,0.35144927536231885,108,198,0.545,0.5348101265822784,105,119,0.8823529411764706,15,77,92,99,26,9,51,86,612,2063280
Jontay Porter,PF,21,MEM,11,0,54,8,15,0.5333333333333333,3,8,0.375,5,7,0.7140000000000001,0.6333333333333333,3,5,0.6,4,10,14,1,3,1,7,12,22,1900000
Kevin Porter,SG,20,HOU,26,23,835,156,367,0.4250681198910082,50,161,0.3105590062111801,106,206,0.515,0.49318801089918257,69,94,0.7340425531914894,20,79,99,164,19,8,91,61,431,1717981
Michael Porter,SF,22,DEN,61,54,1912,443,817,0.5422276621787026,170,382,0.44502617801047123,273,435,0.628,0.6462668298653611,106,134,0.7910447761194029,91,354,445,70,40,54,77,126,1162,3550800
Otto Porter,PF,27,ORL,56,12,1212,196,454,0.43171806167400884,78,208,0.375,118,246,1.457,0.5176211453744494,72,84,0.8571428571428571,56,248,304,110,32,8,50,82,542,28489239
Bobby Portis,C,25,MIL,66,7,1372,313,598,0.5234113712374582,74,157,0.4713375796178344,239,441,0.542,0.5852842809364549,54,73,0.7397260273972602,124,342,466,71,52,26,56,115,754,3623000
Kristaps Porzingis,C,25,DAL,43,43,1327,325,683,0.47584187408491946,97,258,0.375968992248062,228,425,0.536,0.5468521229868228,118,138,0.855072463768116,82,299,381,68,20,58,51,115,865,29467800
Dwight Powell,C,29,DAL,58,19,966,120,194,0.6185567010309279,5,21,0.23809523809523808,115,173,0.665,0.6314432989690721,97,124,0.782258064516129,80,154,234,63,36,30,40,135,342,11080125
Norman Powell,SF,27,POR,138,116,4410,876,1836,0.477124183006536,342,832,0.4110576923076923,534,1004,1.586,0.5702614379084967,472,542,0.8708487084870848,84,346,430,258,164,36,238,320,2566,10865952
Taurean Prince,PF,26,CLE,82,20,1810,262,654,0.40061162079510704,124,310,0.4,138,344,1.245,0.4954128440366973,130,152,0.8552631578947368,38,246,284,152,56,46,94,150,778,12250000
Payton Pritchard,SG,23,BOS,66,4,1268,184,418,0.44019138755980863,102,248,0.4112903225806452,82,170,0.48200000000000004,0.562200956937799,40,45,0.8888888888888888,33,125,158,120,37,9,53,104,510,2035800
Immanuel Quickley,PG,21,NYK,64,3,1243,229,580,0.39482758620689656,118,303,0.38943894389438943,111,277,0.401,0.496551724137931,155,174,0.8908045977011494,25,112,137,127,30,12,58,114,731,2105520
Jahmi'us Ramsey,SG,19,SAC,13,0,94,15,38,0.39473684210526316,5,19,0.2631578947368421,10,19,0.526,0.4605263157894737,5,5,1.0,2,8,10,6,4,1,3,8,40,1000000
Chasson Randle,PG,27,ORL,41,5,837,92,237,0.3881856540084388,44,130,0.3384615384615385,48,107,0.449,0.4810126582278481,38,48,0.7916666666666666,7,75,82,74,22,5,46,64,266,279927
Julius Randle,PF,26,NYK,71,71,2667,602,1321,0.45571536714610145,160,389,0.41131105398457585,442,932,0.474,0.5162755488266465,348,429,0.8111888111888111,84,639,723,427,64,18,241,225,1712,19845000
Cam Reddish,SF,21,ATL,26,21,750,96,263,0.3650190114068441,33,126,0.2619047619047619,63,137,0.46,0.42775665399239543,67,82,0.8170731707317073,22,82,104,35,33,9,34,68,292,4458000
JJ Redick,SG,36,DAL,88,0,1446,212,534,0.3970037453183521,132,356,0.3707865168539326,80,178,1.202,0.5205992509363296,98,104,0.9423076923076923,8,120,128,102,22,6,72,100,654,13013700
Paul Reed,PF,21,PHI,26,0,177,42,78,0.5384615384615384,0,6,0.0,42,72,0.583,0.5384615384615384,4,8,0.5,30,31,61,12,10,13,12,29,88,609128
Naz Reid,C,21,MIN,70,15,1347,304,581,0.5232358003442341,61,174,0.3505747126436782,243,407,0.597,0.5757314974182444,115,166,0.6927710843373494,82,240,322,72,34,76,69,179,784,1517981
Cameron Reynolds,SF,25,HOU,10,0,80,12,36,0.3333333333333333,6,24,0.25,6,12,1.5,0.4166666666666667,0,0,0.0,4,6,10,4,0,0,0,4,30,144297
Nick Richards,PF,23,CHO,18,0,63,4,9,0.4444444444444444,0,1,0.0,4,8,0.5,0.4444444444444444,7,11,0.6363636363636364,4,7,11,2,0,0,3,7,15,1000000
Josh Richardson,SG,27,DAL,59,56,1790,264,618,0.42718446601941745,88,267,0.3295880149812734,176,351,0.501,0.49838187702265374,99,108,0.9166666666666666,51,144,195,153,61,24,79,130,715,10865952
Grant Riller,PG,23,CHO,7,0,27,8,12,0.6666666666666666,2,4,0.5,6,8,0.75,0.75,0,0,0.0,0,1,1,3,1,0,1,0,18,449115
Austin Rivers,SG,28,DEN,72,14,1690,208,490,0.42448979591836733,110,298,0.3691275167785235,98,192,1.5270000000000001,0.536734693877551,44,62,0.7096774193548387,16,148,164,162,60,4,72,128,570,3929049
Andre Roberson,SG,29,BRK,5,0,63,2,14,0.14285714285714285,1,8,0.125,1,6,0.16699999999999998,0.17857142857142858,1,2,0.5,7,8,15,4,3,1,2,4,6,411639
Duncan Robinson,SF,26,MIA,72,72,2262,315,717,0.4393305439330544,250,613,0.4078303425774878,65,104,0.625,0.6136680613668062,62,75,0.8266666666666667,7,243,250,127,43,20,81,181,942,1663861
Glenn Robinson III,SF,27,SAC,23,2,369,42,99,0.42424242424242425,16,44,0.36363636363636365,26,55,0.473,0.5050505050505051,21,23,0.9130434782608695,11,34,45,20,4,3,11,23,121,1165322
Jerome Robinson,SG,23,WAS,17,6,305,28,95,0.29473684210526313,11,42,0.2619047619047619,17,53,0.321,0.3526315789473684,16,20,0.8,4,34,38,25,12,6,19,31,83,3737520
Justin Robinson,PG,23,OKC,9,0,88,7,21,0.3333333333333333,4,14,0.2857142857142857,3,7,0.429,0.42857142857142855,3,5,0.6,1,6,7,9,3,0,2,10,21,198040
Mitchell Robinson,C,22,NYK,31,29,853,115,176,0.6534090909090909,0,0,0.0,115,176,0.653,0.6534090909090909,26,53,0.49056603773584906,113,139,252,17,35,45,26,86,256,1663861
Isaiah Roby,PF,22,OKC,61,34,1425,207,429,0.4825174825174825,32,109,0.29357798165137616,175,320,0.547,0.5198135198135199,87,117,0.7435897435897436,89,252,341,107,52,37,113,162,533,1517981
Rajon Rondo,PG,34,LAC,90,6,1540,190,430,0.4418604651162791,72,178,0.4044943820224719,118,252,1.408,0.5255813953488372,32,34,0.9411764705882353,36,184,220,398,74,8,158,106,484,7500000
Derrick Rose,PG,32,NYK,100,6,2558,574,1222,0.469721767594108,100,258,0.3875968992248062,474,964,1.4540000000000002,0.5106382978723404,220,254,0.8661417322834646,40,220,260,418,98,38,156,112,1468,7682926
Terrence Ross,SG,29,ORL,46,2,1347,254,616,0.41233766233766234,89,264,0.3371212121212121,165,352,0.469,0.48457792207792205,120,138,0.8695652173913043,15,143,158,108,47,21,74,88,717,13500000
Terry Rozier,SG,26,CHO,69,69,2383,510,1134,0.4497354497354497,222,571,0.38879159369527144,288,563,0.512,0.5476190476190477,165,202,0.8168316831683168,47,255,302,293,87,26,128,119,1407,18900000
Ricky Rubio,PG,30,MIN,68,51,1772,193,498,0.38755020080321284,66,214,0.308411214953271,127,284,0.447,0.4538152610441767,130,150,0.8666666666666667,28,195,223,433,98,4,111,139,582,17000000
D'Angelo Russell,PG,24,MIN,42,26,1196,281,652,0.43098159509202455,120,310,0.3870967741935484,161,342,0.47100000000000003,0.5230061349693251,114,149,0.7651006711409396,16,95,111,244,45,18,112,68,796,28649250
Domantas Sabonis,PF,24,IND,62,62,2231,484,904,0.5353982300884956,52,162,0.32098765432098764,432,742,0.5820000000000001,0.5641592920353983,240,328,0.7317073170731707,150,592,742,415,76,33,213,203,1260,19800000
Luka Samanic,PF,21,SAS,33,4,308,47,105,0.44761904761904764,12,43,0.27906976744186046,35,62,0.565,0.5047619047619047,16,29,0.5517241379310345,16,52,68,15,8,8,20,43,122,2824320
JaKarr Sampson,PF,27,IND,29,4,316,56,113,0.49557522123893805,3,15,0.2,53,98,0.541,0.5088495575221239,19,29,0.6551724137931034,27,50,77,4,2,14,15,52,134,1882867
Dario Saric,C,26,PHO,50,4,871,153,342,0.4473684210526316,47,135,0.34814814814814815,106,207,0.512,0.5160818713450293,84,99,0.8484848484848485,46,144,190,65,30,4,57,95,437,9250000
Tomas Satoransky,SG,29,CHI,58,18,1307,169,329,0.513677811550152,42,118,0.3559322033898305,127,211,0.602,0.5775075987841946,67,79,0.8481012658227848,30,112,142,271,40,14,96,89,447,10000000
Dennis Schroeder,SG,27,LAL,61,61,1956,332,760,0.4368421052631579,71,212,0.33490566037735847,261,548,0.47600000000000003,0.48355263157894735,206,243,0.8477366255144033,30,181,211,351,70,13,163,159,941,15500000
Mike Scott,PF,32,PHI,51,12,852,76,211,0.36018957345971564,53,155,0.3419354838709677,23,56,0.41100000000000003,0.48578199052132703,8,12,0.6666666666666666,11,109,120,40,24,14,19,72,213,5005350
Jay Scrubb,SG,20,LAC,4,1,84,14,36,0.3888888888888889,2,9,0.2222222222222222,12,27,0.444,0.4166666666666667,5,5,1.0,2,12,14,1,4,0,7,5,35,449115
Collin Sexton,SG,22,CLE,60,60,2115,525,1105,0.4751131221719457,98,264,0.3712121212121212,427,841,0.508,0.5194570135746607,312,383,0.814621409921671,58,129,187,262,62,10,167,157,1460,4991880
Landry Shamet,SG,23,BRK,61,12,1403,186,456,0.40789473684210525,129,333,0.38738738738738737,57,123,0.46299999999999997,0.5493421052631579,66,78,0.8461538461538461,11,101,112,99,31,10,48,93,567,2090040
Iman Shumpert,SG,30,BRK,2,0,11,1,4,0.25,0,3,0.0,1,1,1.0,0.25,0,0,0.0,1,0,1,0,1,0,1,0,2,803044
Pascal Siakam,PF,26,TOR,56,56,2006,437,961,0.4547346514047867,73,246,0.2967479674796748,364,715,0.509,0.4927159209157128,249,301,0.8272425249169435,95,310,405,250,64,37,130,174,1196,30559200
Chris Silva,PF,24,SAC,30,0,184,20,32,0.625,2,2,1.0,18,30,1.5999999999999999,0.65625,22,30,0.7333333333333333,14,40,54,12,2,12,20,48,64,1517981
Ben Simmons,PG,24,PHI,58,58,1877,325,583,0.5574614065180102,3,10,0.3,322,573,0.562,0.5600343053173242,176,287,0.6132404181184669,93,324,417,401,93,35,173,171,829,30559200
Anfernee Simons,SG,21,POR,64,0,1104,168,401,0.41895261845386533,120,282,0.425531914893617,48,119,0.40299999999999997,0.5685785536159601,46,57,0.8070175438596491,14,126,140,89,18,8,43,96,502,2252040
Deividas Sirvydis,SG,20,DET,20,0,133,14,40,0.35,10,28,0.35714285714285715,4,12,0.33299999999999996,0.475,3,6,0.5,0,29,29,5,2,0,5,9,41,898310
Alen Smailagic,PF,20,GSW,15,1,84,11,27,0.4074074074074074,4,10,0.4,7,17,0.41200000000000003,0.48148148148148145,2,6,0.3333333333333333,6,10,16,4,3,5,5,11,28,1517981
Marcus Smart,PG,26,BOS,48,45,1581,203,510,0.3980392156862745,93,282,0.32978723404255317,110,228,0.48200000000000004,0.4892156862745098,128,162,0.7901234567901234,36,131,167,273,72,23,96,126,627,12946428
Dennis Smith,PG,23,DET,46,18,840,116,290,0.4,38,116,0.3275862068965517,78,174,1.238,0.46551724137931033,38,52,0.7307692307692307,24,86,110,154,46,28,52,74,308,5686677
Ishmael Smith,PG,32,WAS,44,1,924,129,297,0.43434343434343436,18,49,0.3673469387755102,111,248,0.44799999999999995,0.46464646464646464,19,33,0.5757575757575758,22,128,150,172,32,13,41,62,295,6000000
Jalen Smith,PF,20,PHO,27,1,156,22,50,0.44,4,17,0.23529411764705882,18,33,0.545,0.48,5,7,0.7142857142857143,7,30,37,4,1,5,7,16,53,4245720
Tony Snell,SG,29,ATL,47,23,992,88,171,0.5146198830409356,62,109,0.5688073394495413,26,62,0.419,0.695906432748538,11,11,1.0,18,94,112,59,13,11,21,75,249,12178571
Raymond Spalding,C,23,HOU,2,0,19,2,4,0.5,0,1,0.0,2,3,0.667,0.5,0,2,0.0,2,2,4,0,0,2,3,3,4,289156
Cassius Stanley,SG,21,IND,24,0,93,13,43,0.3023255813953488,3,13,0.23076923076923078,10,30,0.33299999999999996,0.3372093023255814,7,9,0.7777777777777778,8,12,20,1,1,2,1,14,36,470690
Lamar Stevens,PF,23,CLE,40,0,499,62,136,0.45588235294117646,4,25,0.16,58,111,0.523,0.47058823529411764,37,51,0.7254901960784313,24,72,96,25,17,13,23,53,165,1000000
Isaiah Stewart,C,19,DET,68,14,1455,226,409,0.5525672371638142,21,63,0.3333333333333333,205,346,0.5920000000000001,0.578239608801956,64,92,0.6956521739130435,159,294,453,59,39,86,67,184,537,3121080
Max Strus,SF,24,MIA,39,0,507,85,187,0.45454545454545453,50,148,0.33783783783783783,35,39,0.897,0.5882352941176471,16,24,0.6666666666666666,5,36,41,24,11,2,8,43,236,647098
Edmond Sumner,SG,25,IND,53,24,861,148,282,0.524822695035461,35,88,0.3977272727272727,113,194,0.5820000000000001,0.5868794326241135,68,83,0.8192771084337349,18,76,94,49,33,10,51,88,399,2160000
Jae'Sean Tate,SF,25,HOU,70,58,2043,316,625,0.5056,60,195,0.3076923076923077,256,430,0.595,0.5536,102,147,0.6938775510204082,132,242,374,178,85,36,98,222,794,1445697
Jayson Tatum,SF,22,BOS,64,64,2290,605,1318,0.4590288315629742,187,485,0.38556701030927837,418,833,0.502,0.529969650986343,295,340,0.8676470588235294,50,422,472,276,75,31,171,122,1692,9897120
Jeff Teague,PG,32,MIL,110,14,1900,246,568,0.43309859154929575,72,164,0.43902439024390244,174,404,1.325,0.4964788732394366,178,210,0.8476190476190476,30,146,176,264,68,24,128,112,742,3372826
Garrett Temple,SG,34,CHI,56,25,1528,158,381,0.4146981627296588,67,200,0.335,91,181,0.503,0.5026246719160105,40,50,0.8,29,131,160,124,43,30,58,126,423,4767000
Tyrell Terry,PG,20,DAL,11,0,56,5,16,0.3125,0,7,0.0,5,9,0.556,0.3125,1,3,0.3333333333333333,0,6,6,6,5,0,2,2,11,1289846
Daniel Theis,C,28,CHI,130,102,3202,504,932,0.5407725321888412,98,304,0.3223684210526316,406,628,1.935,0.5933476394849786,148,220,0.6727272727272727,186,526,712,216,82,114,132,334,1254,5000000
Brodric Thomas,SG,24,CLE,64,2,798,78,216,0.3611111111111111,32,118,0.2711864406779661,46,98,1.9269999999999998,0.4351851851851852,62,92,0.6739130434782609,16,90,106,60,30,20,44,80,250,412202
Isaiah Thomas,PG,31,NOP,3,0,48,9,27,0.3333333333333333,3,12,0.25,6,15,0.4,0.3888888888888889,2,2,1.0,1,3,4,5,1,0,6,3,23,159698
Khyri Thomas,SG,24,HOU,5,2,153,32,66,0.48484848484848486,9,27,0.3333333333333333,23,39,0.59,0.553030303030303,9,9,1.0,7,11,18,25,9,6,6,8,82,1061283
Matt Thomas,SG,26,UTA,90,0,652,100,254,0.3937007874015748,54,160,0.3375,46,94,1.4369999999999998,0.5,24,28,0.8571428571428571,14,74,88,38,8,0,28,36,278,1517981
Tristan Thompson,PF,29,BOS,54,43,1287,169,326,0.5184049079754601,0,3,0.0,169,323,0.523,0.5184049079754601,71,120,0.5916666666666667,169,270,439,67,24,33,62,119,409,9258000
Sindarius Thornwell,SG,26,ORL,42,2,434,30,92,0.32608695652173914,14,46,0.30434782608695654,16,46,1.045,0.40217391304347827,8,16,0.5,6,30,36,42,26,4,14,30,82,1235889
Matisse Thybulle,SG,23,PHI,65,8,1298,102,243,0.41975308641975306,43,143,0.3006993006993007,59,100,0.59,0.5082304526748971,8,18,0.4444444444444444,30,94,124,63,105,71,32,127,255,2711280
Killian Tillie,C,22,MEM,18,1,182,19,57,0.3333333333333333,10,33,0.30303030303030304,9,24,0.375,0.42105263157894735,9,11,0.8181818181818182,6,18,24,8,5,8,2,20,57,449115
Xavier Tillman,PF,22,MEM,59,12,1085,167,299,0.5585284280936454,22,65,0.3384615384615385,145,234,0.62,0.5953177257525084,34,53,0.6415094339622641,74,182,256,75,44,33,45,116,390,1300000
Anthony Tolliver,PF,35,PHI,11,0,99,4,17,0.23529411764705882,4,14,0.2857142857142857,0,3,0.0,0.35294117647058826,5,6,0.8333333333333334,3,7,10,2,3,2,3,7,17,614838
Obi Toppin,PF,22,NYK,62,0,683,104,209,0.49760765550239233,26,85,0.3058823529411765,78,124,0.629,0.5598086124401914,19,26,0.7307692307692307,26,112,138,29,17,15,23,55,253,4862040
Juan Toscano-Anderson,SG,27,GSW,53,16,1107,121,209,0.5789473684210527,37,92,0.40217391304347827,84,117,0.718,0.6674641148325359,22,31,0.7096774193548387,29,205,234,150,41,26,61,111,301,943963
Axel Toupane,SF,28,MIL,8,1,61,4,11,0.36363636363636365,1,2,0.5,3,9,0.33299999999999996,0.4090909090909091,5,7,0.7142857142857143,0,6,6,4,2,3,0,6,14,196872
Karl-Anthony Towns,C,25,MIN,50,50,1689,425,875,0.4857142857142857,122,315,0.3873015873015873,303,560,0.541,0.5554285714285714,267,311,0.8585209003215434,133,396,529,225,39,57,160,186,1239,29467800
Gary Trent,SG,22,TOR,116,76,3604,640,1570,0.40764331210191085,330,858,0.38461538461538464,310,712,1.304,0.5127388535031847,166,212,0.7830188679245284,54,250,304,160,112,20,86,184,1776,1663861
PJ Tucker,PF,35,MIL,104,66,2712,132,354,0.3728813559322034,80,238,0.33613445378151263,52,116,1.3,0.4858757062146893,42,56,0.75,102,306,408,122,78,40,80,250,386,7969537
Rayjon Tucker,PG,23,PHI,14,0,68,9,18,0.5,2,7,0.2857142857142857,7,11,0.636,0.5555555555555556,14,19,0.7368421052631579,1,10,11,6,2,0,4,8,34,693755
Myles Turner,C,24,IND,47,47,1455,206,432,0.47685185185185186,69,206,0.33495145631067963,137,226,0.606,0.5567129629629629,111,142,0.7816901408450704,63,243,306,48,40,159,67,165,592,18000000
Jonas Valanciunas,C,28,MEM,62,61,1755,440,743,0.5921938088829072,21,57,0.3684210526315789,419,686,0.611,0.6063257065948856,157,203,0.7733990147783252,253,523,776,112,35,57,100,179,1058,15000000
Denzel Valentine,SG,27,CHI,62,3,1036,155,416,0.37259615384615385,80,242,0.3305785123966942,75,174,0.431,0.46875,16,17,0.9411764705882353,24,173,197,105,30,7,42,70,406,4642800
Jarred Vanderbilt,PF,21,MIN,64,30,1139,143,236,0.6059322033898306,1,5,0.2,142,231,0.615,0.6080508474576272,57,102,0.5588235294117647,118,250,368,76,64,46,53,123,344,1663861
Fred VanVleet,SG,26,TOR,52,52,1899,338,870,0.38850574712643676,174,476,0.36554621848739494,164,394,0.41600000000000004,0.4885057471264368,169,191,0.8848167539267016,32,188,220,328,87,37,95,119,1019,21250000
Anderson Varejao,C,38,CLE,5,0,36,4,16,0.25,0,1,0.0,4,15,0.267,0.25,5,9,0.5555555555555556,7,13,20,3,0,2,1,3,13,2141713
Devin Vassell,SF,20,SAS,62,7,1056,123,303,0.40594059405940597,52,150,0.3466666666666667,71,153,0.46399999999999997,0.49174917491749176,43,51,0.8431372549019608,24,150,174,56,43,18,22,88,341,4033440
Gabe Vincent,PG,24,MIA,50,7,655,88,233,0.3776824034334764,46,149,0.3087248322147651,42,84,0.5,0.47639484978540775,20,23,0.8695652173913043,10,46,56,67,21,2,34,79,242,660750
Noah Vonleh,PF,25,BRK,4,0,11,0,3,0.0,0,2,0.0,0,1,0.0,0.0,0,0,0.0,0,1,1,1,0,0,2,2,0,427725
Nikola Vucevic,C,30,CHI,140,140,4696,1332,2792,0.47707736389684813,352,880,0.4,980,1912,1.537,0.5401146131805158,262,312,0.8397435897435898,292,1342,1634,538,130,96,252,274,3278,26000000
Dean Wade,PF,24,CLE,63,19,1212,134,311,0.43086816720257237,78,213,0.36619718309859156,56,98,0.5710000000000001,0.5562700964630225,30,39,0.7692307692307693,38,177,215,74,35,21,30,78,376,1517981
Moritz Wagner,C,23,ORL,90,48,1444,208,458,0.45414847161572053,62,182,0.34065934065934067,146,276,1.8319999999999999,0.5218340611353712,142,174,0.8160919540229885,54,238,292,100,52,36,86,216,620,2383915
Kemba Walker,PG,30,BOS,43,43,1369,284,676,0.42011834319526625,127,353,0.3597733711048159,157,323,0.486,0.5140532544378699,134,149,0.8993288590604027,16,154,170,212,48,12,88,61,829,34379100
Lonnie Walker,SG,22,SAS,60,38,1522,256,609,0.42036124794745483,100,282,0.3546099290780142,156,327,0.47700000000000004,0.5024630541871922,57,70,0.8142857142857143,14,141,155,101,29,15,65,101,669,2895720
John Wall,PG,30,HOU,40,40,1288,293,726,0.4035812672176309,79,249,0.3172690763052209,214,477,0.449,0.45798898071625344,158,211,0.7488151658767772,17,112,129,275,42,31,141,46,823,41254920
Brad Wanamaker,PG,31,CHO,122,0,2106,230,598,0.38461538461538464,32,170,0.18823529411764706,198,428,1.392,0.411371237458194,180,202,0.8910891089108911,36,174,210,348,86,22,142,188,672,2250000
TJ Warren,SF,27,IND,4,4,117,27,51,0.5294117647058824,0,7,0.0,27,44,0.614,0.5294117647058824,8,10,0.8,2,12,14,5,2,0,4,16,62,12000000
PJ Washington,PF,22,CHO,64,61,1954,302,686,0.4402332361516035,112,290,0.38620689655172413,190,396,0.48,0.521865889212828,108,145,0.7448275862068966,93,325,418,161,69,79,128,171,824,4023600
Yuta Watanabe,SF,26,TOR,50,4,723,79,180,0.4388888888888889,36,90,0.4,43,90,0.478,0.5388888888888889,24,29,0.8275862068965517,36,123,159,40,26,19,19,57,218,737996
Tremont Waters,PG,23,BOS,26,3,238,34,84,0.40476190476190477,15,38,0.39473684210526316,19,46,0.413,0.49404761904761907,16,17,0.9411764705882353,5,16,21,62,15,1,27,17,99,712278
Paul Watson,SF,26,TOR,27,2,297,38,82,0.4634146341463415,30,64,0.46875,8,18,0.444,0.6463414634146342,5,8,0.625,4,41,45,17,6,3,9,36,111,1445697
Quinndary Weatherspoon,SG,24,SAS,20,0,121,16,35,0.45714285714285713,1,6,0.16666666666666666,15,29,0.517,0.4714285714285714,13,16,0.8125,3,8,11,8,8,2,10,18,46,449115
Russell Westbrook,PG,32,WAS,65,65,2369,544,1238,0.4394184168012924,86,273,0.315018315018315,458,965,0.475,0.47415185783521807,271,413,0.6561743341404358,109,641,750,763,89,23,312,190,1445,41358814
Coby White,PG,20,CHI,69,54,2156,375,902,0.4157427937915743,163,454,0.3590308370044053,212,448,0.473,0.5060975609756098,128,142,0.9014084507042254,28,256,284,328,38,15,156,179,1041,5572680
Derrick White,SG,26,SAS,36,32,1064,186,453,0.4105960264900662,84,243,0.345679012345679,102,210,0.486,0.5033112582781457,97,114,0.8508771929824561,13,94,107,127,26,36,45,91,553,3516284
Hassan Whiteside,C,31,SAC,36,4,546,126,224,0.5625,0,1,0.0,126,223,0.565,0.5625,41,79,0.5189873417721519,61,154,215,20,9,46,40,73,293,2320044
Greg Whittington,PF,27,DEN,4,0,12,0,3,0.0,0,2,0.0,0,1,0.0,0.0,0,0,0.0,0,0,0,0,0,0,0,0,0,332252
Andrew Wiggins,PF,25,GSW,71,71,2364,505,1058,0.4773156899810964,140,368,0.3804347826086957,365,690,0.529,0.5434782608695652,170,238,0.7142857142857143,82,265,347,167,67,70,126,159,1320,29542010
Grant Williams,PF,22,BOS,63,9,1138,108,247,0.43724696356275305,48,129,0.37209302325581395,60,118,0.508,0.5344129554655871,30,51,0.5882352941176471,48,130,178,64,32,24,56,161,294,2498760
Kenrich Williams,PF,26,OKC,66,13,1426,219,411,0.5328467153284672,52,117,0.4444444444444444,167,294,0.568,0.5961070559610706,36,63,0.5714285714285714,84,189,273,152,55,17,76,143,526,2000000
Louis Williams,PG,34,ATL,132,8,2846,530,1292,0.4102167182662539,138,346,0.3988439306358382,392,946,1.221,0.46362229102167185,300,346,0.8670520231213873,42,234,276,450,94,12,216,124,1498,8000000
Patrick Williams,PF,19,CHI,71,71,1983,255,528,0.48295454545454547,54,138,0.391304347826087,201,390,0.515,0.5340909090909091,91,125,0.728,66,261,327,99,64,46,98,126,655,7068360
Robert Williams,C,23,BOS,52,13,985,186,258,0.7209302325581395,0,2,0.0,186,256,0.727,0.7209302325581395,45,73,0.6164383561643836,133,225,358,94,43,91,52,105,417,2029920
Zion Williamson,PF,20,NOP,61,61,2026,634,1037,0.6113789778206364,10,34,0.29411764705882354,624,1003,0.622,0.6162005785920925,369,529,0.6975425330812854,167,274,441,226,57,39,167,135,1647,10245480
DJ Wilson,PF,24,HOU,70,2,866,136,336,0.40476190476190477,60,174,0.3448275862068966,76,162,1.354,0.49404761904761907,34,50,0.68,40,184,224,46,22,32,44,88,366,4548280
Dylan Windler,SF,24,CLE,31,0,513,57,130,0.43846153846153846,26,77,0.33766233766233766,31,53,0.585,0.5384615384615384,21,27,0.7777777777777778,20,87,107,33,19,12,32,37,161,2137440
Justise Winslow,SF,24,MEM,26,1,507,74,210,0.3523809523809524,10,54,0.18518518518518517,64,156,0.41,0.3761904761904762,20,35,0.5714285714285714,18,100,118,50,15,12,37,47,178,13000000
Cassius Winston,PG,22,WAS,22,0,98,14,33,0.42424242424242425,8,17,0.47058823529411764,6,16,0.375,0.5454545454545454,5,6,0.8333333333333334,0,9,9,12,2,1,5,8,41,449115
James Wiseman,C,19,GSW,39,27,836,191,368,0.5190217391304348,12,38,0.3157894736842105,179,330,0.542,0.5353260869565217,54,86,0.627906976744186,55,171,226,26,11,36,60,121,448,8730240
Christian Wood,C,25,HOU,41,41,1326,329,640,0.5140625,77,206,0.3737864077669903,252,434,0.581,0.57421875,125,198,0.6313131313131313,76,319,395,71,34,48,80,88,860,13015874
Robert Woodard,SF,21,SAC,13,0,45,8,20,0.4,1,6,0.16666666666666666,7,14,0.5,0.425,3,8,0.375,4,12,16,2,0,3,1,4,20,1500000
Delon Wright,PG,28,SAC,126,78,3496,480,1036,0.46332046332046334,128,344,0.37209302325581395,352,692,1.524,0.525096525096525,202,252,0.8015873015873016,130,408,538,556,202,60,166,150,1290,9000000
Thaddeus Young,PF,32,CHI,68,23,1652,370,662,0.5589123867069486,12,45,0.26666666666666666,358,617,0.58,0.56797583081571,71,113,0.6283185840707964,168,255,423,291,74,40,137,152,823,13545000
Trae Young,PG,22,ATL,63,63,2125,487,1112,0.4379496402877698,136,397,0.3425692695214106,351,715,0.491,0.49910071942446044,484,546,0.8864468864468864,38,207,245,594,53,12,261,111,1594,6571800
Cody Zeller,C,28,CHO,48,21,1005,181,324,0.558641975308642,4,28,0.14285714285714285,177,296,0.598,0.5648148148148148,85,119,0.7142857142857143,119,209,328,86,27,17,51,121,451,15415730
Ivica Zubac,C,23,LAC,72,33,1609,257,394,0.6522842639593909,1,4,0.25,256,390,0.6559999999999999,0.6535532994923858,135,171,0.7894736842105263,189,330,519,90,24,62,81,187,650,7000000
